"FIPS","Year","Alzheimers Deaths","Population","STATE","COUNTY","PM2_5GE_Threshold","PM2_5GT35LE50","PM2_5GT50","Poverty Percent, All Ages","% Smokers","% Excessive Drinking","% African American","% Asian","% Hispanic","% Age < 18","% Age 65 and over","% Obese","% Unemployed","% Uninsured","Median Household Income","% Rural","PM2_5GE_ThresholdLastYear","PM2_5GE_ThresholdLast2Year","PM2_5GE_ThresholdLast3Year","PM2_5GE_ThresholdLast4Year","PM2_5GE_ThresholdLast5Year","PM2_5GT35LE50LastYear","PM2_5GT35LE50Last2Year","PM2_5GT35LE50Last3Year","PM2_5GT35LE50Last4Year","PM2_5GT35LE50Last5Year","PM2_5GT50LastYear","PM2_5GT50Last2Year","PM2_5GT50Last3Year","PM2_5GT50Last4Year","PM2_5GT50Last5Year"
6001,2015,562,1638215,"California","Alameda",0,0,0,11.5,10.6,19.4,11.51491775,28.20106011,22.67458615,21.73531928,12.15017376,20.5,7.413177706,14.74294644,72128,0.388605754,1,3,3,5,5,1,3,3,5,5,0,0,0,0,0
6001,2016,583,1647704,"California","Alameda",0,0,0,10.7,10.6,16.3,11.21985498,28.86075729,22.67466871,21.40998845,12.45660091,20,5.877024106,14.41522675,76996,0.388605754,0,1,3,3,5,0,1,3,3,5,0,0,0,0,0
6001,2017,618,1663190,"California","Alameda",7,5,2,9.3,9.873413685,16.94587654,10.94648749,29.51828667,22.588366,21.13898359,12.74014705,20,4.744492361,9.598107071,81462,0.388605754,0,0,1,3,3,0,0,1,3,3,0,0,0,0,0
6001,2018,628,1666753,"California","Alameda",14,2,12,9,10.67353273,19.58502523,10.71333201,30.21519642,22.52054981,20.96784374,13.07370741,18.9,4.240276782,6.042725536,89472,0.388605754,7,7,7,8,10,5,5,5,6,8,2,2,2,2,2
6001,2019,622,1671329,"California","Alameda",0,0,0,8.9,10.67353273,19.58502523,10.47523133,31.08778913,22.46718655,20.7230082,13.47837589,19.1,3.642664749,5.261262409,95550,0.388605754,14,21,21,21,22,2,7,7,7,8,12,14,14,14,14
6007,2015,156,225411,"California","Butte",0,0,0,21.4,19.2,20.4,1.472826332,4.427934621,15.14791301,20.33139718,16.65901211,24.4,10.03576972,19.31215631,42395,18.90181818,2,2,7,9,9,2,2,5,7,7,0,0,2,2,2
6007,2016,210,226864,"California","Butte",1,1,0,19.5,15,19.9,1.486793227,4.616461753,15.45167922,20.17026324,17.03925687,25.2,8.653506534,17.10859624,42302,18.90181818,0,2,2,7,9,0,2,2,5,7,0,0,0,2,2
6007,2017,182,229294,"California","Butte",3,3,0,18.1,14.5094653,20.91615579,1.525657577,4.683001273,15.74945322,20.11791794,17.54262214,25.9,7.209208599,13.07519027,45369,18.90181818,1,1,3,3,8,1,1,3,3,6,0,0,0,0,2
6007,2018,193,231256,"California","Butte",24,10,14,18.5,14.15561774,18.93858454,1.517649341,4.718245292,15.99284153,20.05122011,17.99095493,25.4,6.541307089,8.089366993,45097,18.90181818,3,4,4,6,6,3,4,4,6,6,0,0,0,0,0
6007,2019,134,219186,"California","Butte",1,1,0,16.1,14.15561774,18.93858454,1.523807862,4.805620732,16.38464155,20.00488456,18.15049674,25.4,5.744693247,7.09638845,48634,18.90181818,24,27,28,28,30,10,13,14,14,16,14,14,14,14,14
6009,2015,22,44828,"California","Calaveras",4,0,4,13,19.1,23.9,0.862630574,1.491632034,11.10636864,18.0119061,24.26148489,24.3,10.42877907,16.47886081,52598,75.40918864,0,1,1,1,1,0,1,1,1,1,0,0,0,0,0
6009,2016,14,45171,"California","Calaveras",0,0,0,13.1,11.6,18.2,0.860523485,1.517120832,11.50053783,17.73261026,25.09411976,25.3,8.080957305,16.18748128,53321,75.40918864,4,4,5,5,5,0,0,1,1,1,4,4,4,4,4
6009,2017,22,45670,"California","Calaveras",4,3,1,13.1,11.74827567,19.09223103,0.869991969,1.597216026,11.52404747,17.38868564,25.86553047,23.5,6.451925876,10.63489187,52471,75.40918864,0,4,4,5,5,0,0,0,1,1,0,4,4,4,4
6009,2018,22,45602,"California","Calaveras",16,11,5,12.1,11.74399119,18.29147197,0.77926103,1.616081114,11.61585973,17.17252219,26.32662549,25.8,5.627809123,7.143074073,57990,75.40918864,4,4,8,8,9,3,3,3,3,4,1,1,5,5,5
6009,2019,23,45905,"California","Calaveras",0,0,0,12.1,11.74399119,18.29147197,0.783884388,1.650974381,12.06919203,17.04839063,26.8797898,24.5,4.725264351,6.267996242,58536,75.40918864,16,20,20,24,24,11,14,14,14,14,5,6,6,10,10
6013,2015,494,1126745,"California","Contra Costa",0,0,0,10.2,11.6,18.4,8.8487989,15.93586211,24.94084747,23.81811452,13.81221983,22.4,7.390218376,13.78403415,78909,0.792736112,0,2,2,4,6,0,2,2,4,6,0,0,0,0,0
6013,2016,515,1135127,"California","Contra Costa",0,0,0,8.7,11,17.4,8.812882478,16.39121816,25.15515068,23.43416365,14.2349904,22.9,6.15949355,13.98797582,80338,0.792736112,0,0,2,2,4,0,0,2,2,4,0,0,0,0,0
6013,2017,546,1147439,"California","Contra Costa",8,5,3,9.1,10.61901268,18.01611135,8.804831617,16.83051622,25.29640691,23.19247035,14.59993166,25,5.005927833,9.816823816,83036,0.792736112,0,0,0,2,2,0,0,0,2,2,0,0,0,0,0
6013,2018,572,1150215,"California","Contra Costa",14,3,11,7.8,10.46856736,16.27890933,8.773291447,17.12090365,25.43442276,23.04200323,14.95392146,24.2,4.427859266,6.520420256,90920,0.792736112,8,8,8,8,10,5,5,5,5,7,3,3,3,3,3
6013,2019,572,1153526,"California","Contra Costa",0,0,0,7.9,10.46856736,16.27890933,8.725605457,17.70142029,25.67317304,22.83485222,15.29109608,25.2,3.798440401,5.938883052,95062,0.792736112,14,22,22,22,22,3,8,8,8,8,11,14,14,14,14
6017,2015,70,184452,"California","El Dorado",0,0,0,9.1,14.3,20.9,0.781899118,3.930955172,12.46911746,21.32807299,17.1693161,21,8.512781484,13.43198634,63002,34.69993041,1,1,1,1,1,0,0,0,0,0,1,1,1,1,1
6017,2016,63,185625,"California","El Dorado",0,0,0,8.7,11.6,20.6,0.852053942,4.03087057,12.67430238,20.88132964,17.95976776,19.4,6.995731838,13.29617781,70235,34.69993041,0,1,1,1,1,0,0,0,0,0,0,1,1,1,1
6017,2017,74,188987,"California","El Dorado",0,0,0,8.3,11.25937113,19.38731381,0.865807907,4.179949255,12.81254744,20.55765186,18.64604342,20.6,5.667575543,9.255792419,75575,34.69993041,0,0,1,1,1,0,0,0,0,0,0,0,1,1,1
6017,2018,77,190678,"California","El Dorado",4,4,0,8.1,10.99345121,22.17481303,0.878653199,4.323232323,12.76713805,20.30922559,19.39771044,18.7,5.067029208,6.216658178,75100,34.69993041,0,0,0,1,1,0,0,0,0,0,0,0,0,1,1
6017,2019,75,192843,"California","El Dorado",0,0,0,8.7,10.99345121,22.17481303,0.873605063,4.515654516,12.84638626,20.0378862,20.35272267,20.1,4.36107959,5.359964646,78464,34.69993041,4,4,4,4,5,4,4,4,4,4,0,0,0,0,1
6019,2015,354,974861,"California","Fresno",9,5,4,25.2,13.9,17.5,4.762308536,10.51920291,51.56562738,29.11317405,10.85607031,28.5,12.8790685,22.33475633,43741,10.80520178,22,43,57,80,86,13,30,42,56,61,9,13,15,24,25
6019,2016,330,979915,"California","Fresno",4,4,0,25.5,13.4,16.9,4.731183241,10.68134339,51.9445658,28.87665714,11.16862359,28.8,11.61325285,20.28748798,43338,10.80520178,9,31,52,66,89,5,18,35,47,61,4,13,17,19,28
6019,2017,370,989255,"California","Fresno",17,12,5,21.1,13.62686921,17.67179689,4.73021282,10.7220414,52.39731613,28.67526755,11.49640821,26.6,10.19028836,15.44571021,46608,10.80520178,4,13,35,56,70,4,9,22,39,51,0,4,13,17,19
6019,2018,371,994400,"California","Fresno",18,9,9,21.3,14.18186937,16.09479989,4.680610053,10.80348806,52.7865172,28.62391126,11.84500697,26.8,9.43329419,10.81741509,48323,10.80520178,17,21,30,52,73,12,16,21,34,51,5,5,9,18,22
6019,2019,399,999101,"California","Fresno",0,0,0,20.5,14.18186937,16.09479989,4.646729104,10.95218119,53.1647553,28.47435697,11.98144058,28.6,8.467620859,9.385984176,51452,10.80520178,18,35,39,48,70,9,21,25,30,43,9,14,14,18,27
6021,2015,12,28017,"California","Glenn",0,0,0,18.5,15,17,0.765926986,2.884753042,39.52755906,27.09735147,14.56335004,25.9,12.19836002,22.8769134,42129,40.87191523,0,1,2,3,3,0,1,2,3,3,0,0,0,0,0
6021,2016,14,28085,"California","Glenn",0,0,0,16.7,14.7,17.6,0.736898587,2.979788947,40.38991236,26.71793955,14.85959578,28.3,10.65230865,22.48252489,43755,40.87191523,0,0,1,2,3,0,0,1,2,3,0,0,0,0,0
6021,2017,14,28094,"California","Glenn",6,5,1,14.8,14.28177335,17.01058704,0.767391227,3.098118999,41.13216975,26.73733805,15.06228361,26.7,8.733790999,18.00545749,43584,40.87191523,0,0,0,1,2,0,0,0,1,2,0,0,0,0,0
6021,2018,16,28047,"California","Glenn",17,8,9,15.4,14.00330581,17.63831817,0.78689692,3.111981485,41.67349119,26.50881253,15.49581627,27,8.21174853,11.61034306,46141,40.87191523,6,6,6,6,7,5,5,5,5,6,1,1,1,1,1
6021,2019,13,28393,"California","Glenn",0,0,0,12.1,14.00330581,17.63831817,0.808001709,3.082508721,41.93066135,26.42201182,15.62255286,25.6,7.456445993,9.869606245,49979,40.87191523,17,23,23,23,23,8,13,13,13,13,9,10,10,10,10
6023,2015,43,135727,"California","Humboldt",0,0,0,20.9,18.6,22,1.147271605,2.538422074,10.47563814,19.45156997,14.8007703,25.7,8.795836615,20.92690299,40882,29.75865937,1,2,2,2,2,1,2,2,2,2,0,0,0,0,0
6023,2016,49,136646,"California","Humboldt",0,0,0,20,15.2,19.8,1.176479315,2.753525358,10.8264285,19.45938328,15.41440112,24.5,6.782362034,20.83139929,40581,29.75865937,0,1,2,2,2,0,1,2,2,2,0,0,0,0,0
6023,2017,40,136754,"California","Humboldt",7,4,3,19.7,15.9289783,20.89400365,1.227463953,2.888150479,11.12674707,19.53774857,16.05502221,25.5,5.628023566,14.91656547,40739,29.75865937,0,0,1,2,2,0,0,1,2,2,0,0,0,0,0
6023,2018,27,136373,"California","Humboldt",5,4,1,20.3,15.27977715,20.38809677,1.178958769,2.88702194,11.34464236,19.44806288,16.55225912,27.5,4.882407378,8.93508881,43164,29.75865937,7,7,7,8,9,4,4,4,5,6,3,3,3,3,3
6023,2019,26,135558,"California","Humboldt",0,0,0,19.1,15.27977715,20.38809677,1.19119002,2.909604107,11.71080919,19.23892537,17.21631543,26.7,4.187625954,8.328815642,46123,29.75865937,5,12,12,12,13,4,8,8,8,9,1,4,4,4,4
6025,2015,12,180191,"California","Imperial",5,3,2,24.3,12.4,15.8,2.567616545,2.357518235,81.8222489,28.8474607,11.51803108,22.1,24.48877868,22.56506429,40106,17.41783553,10,10,11,13,14,8,8,9,11,12,2,2,2,2,2
6025,2016,15,180883,"California","Imperial",3,3,0,23.6,14.4,16.5,2.538374346,2.344618099,82.27604961,28.53912257,12.01791268,25,23.61772108,21.46049864,38737,17.41783553,5,15,15,16,18,3,11,11,12,14,2,4,4,4,4
6025,2017,31,182830,"California","Imperial",7,6,1,20.7,13.77491179,17.33285316,2.541192401,2.356388499,82.6728305,28.36934142,12.4545621,26.3,24.00836396,15.98651812,39925,17.41783553,3,8,18,18,19,3,6,14,14,15,0,2,4,4,4
6025,2018,40,181827,"California","Imperial",6,5,1,21.4,13.43298112,16.62235449,2.46457655,2.202528706,83.75413942,28.65498693,12.68941802,28.1,23.52106996,10.6469466,43327,17.41783553,7,10,15,25,25,6,9,12,20,20,1,1,3,5,5
6025,2019,55,181215,"California","Imperial",1,0,1,22,13.43298112,16.62235449,2.544987147,2.176338675,84.26297654,28.60362085,12.6029645,27.4,19.06596377,8.326798269,43413,17.41783553,6,13,16,21,31,5,11,14,17,25,1,2,2,4,6
6029,2015,365,882176,"California","Kern",6,3,3,21.9,16,15.7,5.262554911,4.956811754,50.88089209,29.65847494,9.646185038,28,11.75709611,21.03911897,46688,10.20603098,19,38,51,60,74,15,31,42,50,63,4,7,9,10,11
6029,2016,363,884788,"California","Kern",1,1,0,22.4,16.7,19.1,5.280080129,5.02704699,51.54718388,29.44377302,9.855829424,28.5,10.43538163,20.44509035,47451,10.20603098,6,25,44,57,66,3,18,34,45,53,3,7,10,12,13
6029,2017,323,893119,"California","Kern",6,6,0,21.2,14.55685083,16.70431377,5.267656341,5.12970201,52.170882,29.21491857,10.08778294,30.3,10.21220833,14.51291957,51150,10.20603098,1,7,26,45,58,1,4,19,35,46,0,3,7,10,12
6029,2018,355,896764,"California","Kern",9,7,2,20.5,16.19314053,19.47817329,5.216051755,5.180223963,52.84599249,29.16563064,10.36621202,31.6,10.323806,9.652643406,49812,10.20603098,6,7,13,32,51,6,7,10,25,41,0,0,3,7,10
6029,2019,351,900202,"California","Kern",1,1,0,19,16.19314053,19.47817329,5.193932723,5.361211664,53.43487262,29.01293109,10.67125434,30.6,9.207053494,8.147554808,49904,10.20603098,9,15,16,22,41,7,13,14,17,32,2,2,2,5,9
6031,2015,52,150965,"California","Kings",27,18,9,22.4,12.5,14.7,6.317567568,4.321012189,52.69674086,27.72522523,8.787095919,23.7,13.52224832,19.79710217,45794,10.85160346,30,75,100,137,160,4,33,51,74,91,26,42,49,63,69
6031,2016,38,149785,"California","Kings",25,20,5,17.4,15.5,18.8,6.177588192,4.427393541,53.18994603,27.53927956,9.102343131,24.9,12.05721952,18.81542677,44490,10.85160346,27,57,102,127,164,18,22,51,69,92,9,35,51,58,72
6031,2017,31,150101,"California","Kings",31,13,18,18.4,15.23436257,19.95063334,6.137846521,4.497731262,53.63031166,27.44675918,9.370383864,26.4,10.48771293,14.28857415,46440,10.85160346,25,52,82,127,152,20,38,42,71,89,5,14,40,56,63
6031,2018,33,151366,"California","Kings",33,20,13,18.8,14.54645021,19.16708836,6.082718563,4.50312114,54.1709784,27.32917181,9.706579431,25.9,9.96624871,8.880196413,51320,10.85160346,31,56,83,113,158,13,33,51,55,84,18,23,32,58,74
6031,2019,29,152940,"California","Kings",20,19,1,16,14.54645021,19.16708836,5.970646431,4.473654406,54.82441823,27.29095742,10.02924697,24,8.869598364,8.283719716,55076,10.85160346,33,64,89,116,146,20,33,53,71,75,13,31,36,45,71
6033,2015,31,64591,"California","Lake",1,0,1,20.5,24.5,20.7,1.799248356,1.348261823,18.43094269,20.36955841,19.83870968,26.5,11.88696172,20.62504859,36973,33.10600789,0,0,0,0,0,0,0,0,0,0,0,0,0,0,0
6033,2016,26,64116,"California","Lake",0,0,0,20.7,15.3,16.9,1.840022436,1.394428518,19.05926711,20.39293282,20.61884582,26.6,8.864608394,20.27221053,36333,33.10600789,1,1,1,1,1,0,0,0,0,0,1,1,1,1,1
6033,2017,22,64246,"California","Lake",2,1,1,20.2,14.97928557,16.95350764,1.808301466,1.405768606,19.63741079,20.54001332,21.33114521,26.2,7.669869595,15.87950468,37993,33.10600789,0,1,1,1,1,0,0,0,0,0,0,1,1,1,1
6033,2018,11,64382,"California","Lake",3,1,2,18.4,15.40097745,17.01928146,1.748393537,1.374071995,19.96381558,20.72649573,21.8759748,26.3,6.641023895,10.2970218,40818,33.10600789,2,2,3,3,3,1,1,1,1,1,1,1,2,2,2
6033,2019,17,64386,"California","Lake",0,0,0,18.3,15.40097745,17.01928146,1.810229431,1.380630701,20.56003487,20.74214737,22.35625564,23.9,5.74140136,8.657595451,45797,33.10600789,3,5,5,6,6,1,2,2,2,2,2,3,3,4,4
6037,2015,3815,10170292,"California","Los Angeles",5,5,0,16.7,12.3,15.4,8.234495363,14.56246479,48.26697792,23.18753352,11.8504836,21.3,9.870681887,24.51235453,54443,0.605218358,1,1,3,6,6,0,0,2,5,5,1,1,1,1,1
6037,2016,4016,10137915,"California","Los Angeles",0,0,0,16.3,12.4,16.8,8.168845489,14.77249757,48.41245247,22.77042772,12.18783191,21,8.259006427,23.65550176,55686,0.605218358,5,6,6,8,11,5,5,5,7,10,0,1,1,1,1
6037,2017,4192,10163507,"California","Los Angeles",3,2,1,14.9,11.70026618,18.54165894,8.103602139,14.97819335,48.44168683,22.41665234,12.55947224,21.4,6.721462368,17.37042372,59045,0.605218358,0,5,6,6,8,0,5,5,5,7,0,0,1,1,1
6037,2018,4119,10105518,"California","Los Angeles",2,1,1,14.2,10.60574833,17.26186136,8.059428393,15.07489459,48.51914817,22.22461917,12.90771327,21.6,5.244530615,12.49206462,61308,0.605218358,3,3,8,9,9,2,2,7,7,7,1,1,1,2,2
6037,2019,4429,10039107,"California","Los Angeles",0,0,0,13.4,10.60574833,17.26186136,7.983071198,15.2968557,48.60138336,21.89111495,13.22338834,21.4,4.689620259,10.67326313,64912,0.605218358,2,5,5,10,11,1,3,3,8,8,1,2,2,2,3
6039,2015,70,154998,"California","Madera",12,6,6,22.6,13.8,15,3.094055345,2.525116642,55.72711941,28.12473341,12.51008931,27.6,11.36818752,24.64992605,41223,32.92480032,14,26,35,62,71,8,19,25,39,43,6,7,10,23,28
6039,2016,65,154697,"California","Madera",8,8,0,20.4,15.7,17.6,3.332298056,2.45943008,56.14178119,27.56231074,12.77337785,26.7,11.04868321,22.83529606,43171,32.92480032,12,26,38,47,74,6,14,25,31,45,6,12,13,16,29
6039,2017,70,156890,"California","Madera",17,12,5,21.2,14.95498092,16.57156604,3.331655892,2.567129899,56.70008645,27.49390315,13.14468574,26.5,10.49598785,17.3530386,46593,32.92480032,8,20,34,46,55,8,14,22,33,39,0,6,12,13,16
6039,2018,57,157672,"California","Madera",24,17,7,20.2,14.2694435,17.08541659,3.261860282,2.43443635,57.40382813,27.50021009,13.51803849,26.3,9.162491052,13.01505594,49467,32.92480032,17,25,37,51,63,12,20,26,34,45,5,5,11,17,18
6039,2019,64,157327,"California","Madera",0,0,0,17.6,14.2694435,17.08541659,3.252597361,2.540633565,57.95143094,27.41602397,13.73701319,26.2,8.054619729,9.700987688,50783,32.92480032,24,41,49,61,75,17,29,37,43,51,7,12,12,18,24
6041,2015,171,261221,"California","Marin",3,3,0,7.5,9.7,22,2.549106884,5.972171153,15.73355524,20.58637973,18.91393958,15.8,5.043906014,12.3086402,94347,6.519973535,1,2,2,3,5,1,2,2,3,5,0,0,0,0,0
6041,2016,174,260651,"California","Marin",0,0,0,7.8,10.5,18.4,2.578331735,6.101629914,15.96433365,20.46941515,19.40095877,18.1,4.269873118,11.90966414,94549,6.519973535,3,4,5,5,6,3,4,5,5,6,0,0,0,0,0
6041,2017,182,260955,"California","Marin",6,4,2,7.9,9.979472795,21.07038975,2.56258111,6.20968452,16.03661268,20.48839871,20.0316973,18.9,3.54229998,8.699220958,99868,6.519973535,0,3,4,5,5,0,3,4,5,5,0,0,0,0,0
6041,2018,174,259666,"California","Marin",13,2,11,6.6,9.669764224,19.88491928,2.50756759,6.32071237,16.00876268,20.46184362,20.5976574,18.1,3.23765233,6.243984779,103488,6.519973535,6,6,9,10,11,4,4,7,8,9,2,2,2,2,2
6041,2019,148,258826,"California","Marin",0,0,0,6.9,9.669764224,19.88491928,2.460577494,6.404552509,16.12423598,20.11342952,21.62211876,18.2,2.857587681,5.277426619,112735,6.519973535,13,19,19,22,23,2,6,6,9,10,11,13,13,13,13
6045,2015,15,87649,"California","Mendocino",3,1,2,20.3,18.2,24.1,0.650289017,2.050646848,23.53770988,21.66597853,18.15189467,24.2,7.749959767,21.91184044,42001,45.23058708,0,0,0,0,0,0,0,0,0,0,0,0,0,0,0
6045,2016,14,87628,"California","Mendocino",0,0,0,19,15,17.2,0.703319715,2.179380669,24.09723566,21.89395578,18.92362494,23.2,6.910658193,22.04235002,42840,45.23058708,3,3,3,3,3,1,1,1,1,1,2,2,2,2,2
6045,2017,15,88018,"California","Mendocino",5,4,1,16.3,13.36413462,18.87620106,0.729044256,2.176864539,24.53422173,21.65683579,19.83137286,22.4,5.854701918,15.84941564,43237,45.23058708,0,3,3,3,3,0,1,1,1,1,0,2,2,2,2
6045,2018,19,87606,"California","Mendocino",15,7,8,17.5,14.09600528,18.69794971,0.701830465,2.07810289,24.9532113,21.66887296,20.59729767,24.9,5.22513483,12.01049657,45247,45.23058708,5,5,8,8,8,4,4,5,5,5,1,1,3,3,3
6045,2019,14,86749,"California","Mendocino",0,0,0,14,14.09600528,18.69794971,0.758935672,2.192733305,25.37549138,21.64102797,21.21270649,27.1,4.482163838,9.892485684,50453,45.23058708,15,20,20,23,23,7,11,11,12,12,8,9,9,11,11
6047,2015,56,268455,"California","Merced",17,14,3,25.9,11.7,14.2,3.209005121,8.113118665,56.76371815,30.35619311,10.2135791,31.1,14.67731913,20.78982032,41003,14.27326002,18,38,45,65,77,15,32,39,56,66,3,6,6,9,11
6047,2016,63,268672,"California","Merced",6,6,0,20.3,15.6,16.2,3.177737814,8.050969953,57.50301292,29.96474603,10.45116819,29.3,12.80137972,21.03236213,43818,14.27326002,17,35,55,62,82,14,29,46,53,70,3,6,9,9,12
6047,2017,62,272673,"California","Merced",17,14,3,23,15.33298897,17.19339828,3.100333389,8.070626362,58.15127303,29.85677302,10.62263694,29.5,11.35064213,14.85223563,42879,14.27326002,6,23,41,61,68,6,20,35,52,59,0,3,6,9,9
6047,2018,64,274765,"California","Merced",25,13,12,21.2,14.45934305,17.61845713,3.001429252,7.895873035,58.88220581,29.85238506,10.92298416,26.3,10.4801064,10.13648069,47442,14.27326002,17,23,40,58,78,14,20,34,49,66,3,3,6,9,12
6047,2019,66,277680,"California","Merced",1,1,0,17,14.45934305,17.61845713,2.955554822,8.025730454,59.59115864,29.5738852,11.07076975,25.8,9.304148577,8.370176936,48036,14.27326002,25,42,48,65,83,13,27,33,47,62,12,15,15,18,21
6053,2015,127,433898,"California","Monterey",0,0,0,15.3,12.5,15.4,2.683372743,6.923554076,56.8144189,26.48580077,11.59654499,22,10.13183252,23.53489324,55411,9.816001176,0,0,0,0,0,0,0,0,0,0,0,0,0,0,0
6053,2016,145,435232,"California","Monterey",1,1,0,12.9,13.6,18.9,2.622732668,6.908407211,57.37114693,26.41974851,11.95890055,23.7,9.062207139,24.39357487,57428,9.816001176,0,0,0,0,0,0,0,0,0,0,0,0,0,0,0
6053,2017,110,437907,"California","Monterey",1,1,0,11.9,11.19983658,17.75550548,2.574107279,6.926973621,57.82741566,26.36264744,12.33700086,22.3,8.074242376,17.38815467,60047,9.816001176,1,1,1,1,1,1,1,1,1,1,0,0,0,0,0
6053,2018,120,435594,"California","Monterey",7,6,1,13.3,12.36516151,17.5737807,2.574259246,6.795915742,58.32337696,26.34571907,12.69208147,24.6,7.559410927,11.94934648,62999,9.816001176,1,2,2,2,2,1,2,2,2,2,0,0,0,0,0
6053,2019,110,434061,"California","Monterey",0,0,0,12.6,12.36516151,17.5737807,2.585023761,6.835469632,58.79467558,26.22954189,13.16192708,25.4,7.182900236,11.00997265,70294,9.816001176,7,8,9,9,9,6,7,8,8,8,1,1,1,1,1
6055,2015,64,142456,"California","Napa",1,1,0,10.1,8.5,23.7,1.909838519,7.747673275,33.35589983,22.29095107,16.45881733,24.1,6.251276813,18.38018305,68619,13.40083819,0,1,1,3,3,0,1,1,3,3,0,0,0,0,0
6055,2016,59,142166,"California","Napa",0,0,0,7.9,11.2,18.3,1.955995398,8.119745601,33.67615606,21.80041929,16.81548985,24.3,5.57663997,17.61676668,71063,13.40083819,1,1,2,2,4,1,1,2,2,4,0,0,0,0,0
6055,2017,68,140973,"California","Napa",13,5,8,6.8,11.7169912,19.12515092,1.976750716,8.347138766,33.90380188,21.52313697,17.42362554,23.7,4.604559075,12.53742025,72683,13.40083819,0,1,1,2,2,0,1,1,2,2,0,0,0,0,0
6055,2018,81,139417,"California","Napa",12,3,9,8.8,10.90926044,20.07742855,2.032834855,8.535092779,33.93708763,21.27934949,18.08238257,23.2,4.258709449,8.488951,73112,13.40083819,13,13,14,14,15,5,5,6,6,7,8,8,8,8,8
6055,2019,88,137744,"California","Napa",0,0,0,7.4,10.90926044,20.07742855,2.021663723,8.698828854,34.27890447,21.03026821,18.38649954,21.6,3.656274958,7.221660586,83881,13.40083819,12,25,25,26,26,3,8,8,9,9,9,17,17,17,17
6057,2015,68,98877,"California","Nevada",0,0,0,12.4,14.1,17.1,0.436863544,1.372708758,9.023421589,17.92668024,22.49185336,17.8,7.749040413,16.70369015,55246,42.13478595,2,3,3,3,3,1,2,2,2,2,1,1,1,1,1
6057,2016,47,99107,"California","Nevada",0,0,0,10.9,11.7,18.2,0.46211562,1.446007301,9.158383303,17.77881144,23.43846379,20,6.581639043,17.3980382,57118,42.13478595,0,2,3,3,3,0,1,2,2,2,0,1,1,1,1
6057,2017,39,99814,"California","Nevada",1,0,1,11,11.95747093,19.01084894,0.485451622,1.472536586,9.342921003,17.6259393,24.47586395,21.1,5.457848237,11.71391376,57627,42.13478595,0,0,2,3,3,0,0,1,2,2,0,0,1,1,1
6057,2018,40,99696,"California","Nevada",12,7,5,10.3,11.800872,19.09389128,0.439928562,1.365191157,9.452410022,17.5022955,25.47953222,21.1,4.748136062,8.097078749,60501,42.13478595,1,1,1,3,4,0,0,0,1,2,1,1,1,2,2
6057,2019,61,99755,"California","Nevada",0,0,0,9.4,11.800872,19.09389128,0.471877693,1.378564129,9.456589256,17.33624542,26.52032781,20.3,4.106126308,6.881919321,64901,42.13478595,12,13,13,13,15,7,7,7,7,8,5,6,6,6,7
6059,2015,1444,3169776,"California","Orange",5,5,0,12.7,10.9,17.2,1.574222401,19.18517527,34.22776985,23.34397114,12.75268811,20.7,6.229557654,19.33053728,73827,0.143344433,6,7,10,13,14,6,7,9,12,13,0,0,1,1,1
6059,2016,1429,3172532,"California","Orange",2,2,0,11.1,11.1,19.5,1.600119535,19.64444614,34.34480522,22.95245771,13.14875307,19.8,5.486270045,18.82232023,76061,0.143344433,5,11,12,15,18,5,11,12,14,17,0,0,0,1,1
6059,2017,1427,3190400,"California","Orange",8,6,2,11.5,10.27058097,17.65069624,1.61888411,20.08776015,34.35750665,22.59317378,13.57972929,19.7,4.477383911,13.37086723,78002,0.143344433,2,7,13,14,17,2,7,13,14,16,0,0,0,0,1
6059,2018,1492,3185968,"California","Orange",6,4,2,10.5,9.995160764,16.97840905,1.602442466,20.40130722,34.25311392,22.46281519,13.96301125,19.2,4.015611865,10.02997636,81642,0.143344433,8,10,15,21,22,6,8,13,19,20,2,2,2,2,2
6059,2019,1474,3175692,"California","Orange",1,1,0,9.5,9.995160764,16.97840905,1.624279087,21.01253761,34.22414117,22.12885532,14.30005642,19.5,3.498024497,8.193524887,86031,0.143344433,6,14,16,21,27,4,10,12,17,23,2,4,4,4,4
6061,2015,216,375391,"California","Placer",1,0,1,8.6,8.1,16.4,1.453544563,6.795640728,13.36476917,23.30326782,17.22854599,22.5,7.598475506,12.78867161,73643,13.78719521,3,6,8,14,16,1,3,4,10,11,2,3,4,4,5
6061,2016,198,380531,"California","Placer",0,0,0,7.2,11.4,19.9,1.490204308,7.103423784,13.49846917,22.89759856,17.82084188,22.7,6.263245577,12.73922571,75689,13.78719521,1,4,7,9,15,0,1,3,4,10,1,3,4,5,5
6061,2017,249,386166,"California","Placer",0,0,0,7.8,10.13078658,17.62883677,1.560772634,7.295859517,13.76458146,22.63160278,18.46927604,21.7,5.044450431,8.774233566,76203,13.78719521,0,1,4,7,9,0,0,1,3,4,0,1,3,4,5
6061,2018,262,393149,"California","Placer",13,7,6,7.1,9.715204336,20.88014001,1.565706868,7.366811114,13.81411764,22.44232402,18.95745682,20.7,4.439464128,5.387854581,85326,13.78719521,0,0,1,4,7,0,0,0,1,3,0,0,1,3,4
6061,2019,250,398329,"California","Placer",0,0,0,6.6,9.715204336,20.88014001,1.595945785,7.689180301,14.04551411,22.33055215,19.10473734,20.2,3.844781494,4.548799424,81366,13.78719521,13,13,13,14,17,7,7,7,7,8,6,6,6,7,9
6065,2015,1017,2361026,"California","Riverside",1,1,0,16.2,14.6,17.5,6.030515937,6.657994937,46.9253529,26.8507359,12.83664565,25.9,10.26690125,22.51317507,53909,4.622310233,1,3,3,5,7,1,3,3,5,7,0,0,0,0,0
6065,2016,957,2387741,"California","Riverside",0,0,0,15.3,14.1,17.9,6.01823489,6.80577743,47.43844748,26.34536728,13.19172393,25.5,8.248887411,21.89353917,56877,4.622310233,1,2,4,4,6,1,2,4,4,6,0,0,0,0,0
6065,2017,1036,2423266,"California","Riverside",0,0,0,12.9,13.38756445,18.33455323,6.061305551,6.915595169,47.88812152,25.95685096,13.55707222,26,6.727828451,16.95215442,57895,4.622310233,0,1,2,4,4,0,1,2,4,4,0,0,0,0,0
6065,2018,1066,2450758,"California","Riverside",1,1,0,12.7,12.35872909,19.39338421,6.099405254,6.891450957,48.42103897,25.71195955,13.88471363,25.8,6.063994144,10.86030431,59951,4.622310233,0,0,1,2,4,0,0,1,2,4,0,0,0,0,0
6065,2019,1017,2470546,"California","Riverside",0,0,0,11.3,12.35872909,19.39338421,6.121490583,7.011075136,49.0657237,25.42894589,14.05120197,25.8,5.238382147,9.778983949,63776,4.622310233,1,1,1,2,3,1,1,1,2,3,0,0,0,0,0
6067,2015,570,1501335,"California","Sacramento",6,6,0,16.9,14.6,18,9.777441283,15.42905526,22.25710282,24.68280886,12.38438963,26.9,8.791249193,17.50356208,52980,2.062112169,0,5,6,19,21,0,5,6,16,18,0,0,0,3,3
6067,2016,640,1514460,"California","Sacramento",0,0,0,16.3,15,17.6,9.795847036,15.76585026,22.51154838,24.36441736,12.79943807,26.6,7.326429914,16.85482601,55803,2.062112169,6,6,11,12,25,6,6,11,12,22,0,0,0,0,3
6067,2017,757,1530615,"California","Sacramento",1,1,0,14.1,12.90175025,18.69971526,9.789953608,16.02813496,22.74302537,24.08636314,13.19945249,27.4,6.005088542,11.49362803,58735,2.062112169,0,6,6,11,12,0,6,6,11,12,0,0,0,0,0
6067,2018,839,1540975,"California","Sacramento",13,3,10,14.3,12.53032663,18.90206803,9.805541249,16.19593783,22.95458447,23.9728352,13.5880776,27.6,5.350810909,7.199056106,59728,2.062112169,1,1,7,7,12,1,1,7,7,12,0,0,0,0,0
6067,2019,735,1552058,"California","Sacramento",0,0,0,12.6,12.53032663,18.90206803,9.786131718,16.64357138,23.25483548,23.80160916,13.69462602,26.8,4.640701717,5.809500656,62959,2.062112169,13,14,14,20,20,3,4,4,10,10,10,10,10,10,10
6071,2015,619,2128133,"California","San Bernardino",1,1,0,18.9,16.2,17.3,8.299435302,7.103958061,51.06070713,27.69704234,9.986970706,27.7,10.06140061,21.63530954,52112,4.734499143,0,1,1,20,21,0,1,1,20,21,0,0,0,0,0
6071,2016,750,2140096,"California","San Bernardino",0,0,0,17.6,14.1,17.5,8.284882414,7.273436431,51.65285364,27.23278547,10.33399775,28.7,8.050810174,20.43852369,51951,4.734499143,1,1,2,2,21,1,1,2,2,21,0,0,0,0,0
6071,2017,784,2157404,"California","San Bernardino",0,0,0,16,14.2462402,16.27717945,8.250330219,7.387602185,52.18832658,26.88614856,10.74491115,27.9,6.458596155,14.70650543,53526,4.734499143,0,1,1,2,2,0,1,1,2,2,0,0,0,0,0
6071,2018,709,2171603,"California","San Bernardino",1,1,0,14.9,13.05438795,17.81358298,8.223743234,7.433685218,52.79636988,26.78879826,11.09445558,27.3,5.707481677,9.659271999,56194,4.734499143,0,0,1,1,2,0,0,1,1,2,0,0,0,0,0
6071,2019,702,2180085,"California","San Bernardino",1,1,0,13.3,13.05438795,17.81358298,8.16652792,7.624672987,53.42114875,26.49800408,11.26919205,26.2,4.899423096,9.088863409,60270,4.734499143,1,1,1,2,2,1,1,1,2,2,0,0,0,0,0
6073,2015,1404,3299521,"California","San Diego",0,0,0,13.9,12.1,17.2,4.742542784,11.72561356,32.92883897,22.62036738,12.34854817,22.6,7.547555467,18.42233075,61365,3.297049442,1,1,2,3,3,1,1,2,3,3,0,0,0,0,0
6073,2016,1412,3317749,"California","San Diego",0,0,0,12.4,11.8,20,4.767099412,11.94463741,33.18679022,22.3309762,12.71149903,20.2,6.416087296,17.91070798,66034,3.297049442,0,1,1,2,3,0,1,1,2,3,0,0,0,0,0
6073,2017,1462,3337685,"California","San Diego",0,0,0,11.9,10.79844699,19.73349938,4.76978325,12.10412057,33.40654598,22.06493003,13.09277923,19.1,5.199266419,13.44211026,67053,3.297049442,0,0,1,1,2,0,0,1,1,2,0,0,0,0,0
6073,2018,1467,3343364,"California","San Diego",0,0,0,11.5,11.1223271,21.88115996,4.732335086,12.23609743,33.52649643,21.95238398,13.44399471,20.1,4.678232985,9.488318457,70693,3.297049442,0,0,0,1,1,0,0,0,1,1,0,0,0,0,0
6073,2019,1552,3338330,"California","San Diego",0,0,0,10.3,11.1223271,21.88115996,4.71224816,12.48041682,33.85490243,21.8273444,13.62698997,20.4,4.004972691,8.142917851,76048,3.297049442,0,0,0,0,1,0,0,0,0,1,0,0,0,0,0
6075,2015,332,864816,"California","San Francisco",1,1,0,12.4,9.5,20.6,5.400851641,34.38172435,15.33180805,13.4045104,14.1991923,15.2,5.719153129,13.44784958,76933,0,0,2,3,5,8,0,2,3,5,8,0,0,0,0,0
6075,2016,344,870887,"California","San Francisco",0,0,0,10.2,11.5,19.7,5.252625022,34.93194474,15.28208064,13.44353871,14.41870614,14.8,4.375709901,12.43874705,83788,0,1,1,3,4,6,1,1,3,4,6,0,0,0,0,0
6075,2017,354,884363,"California","San Francisco",8,8,0,10.1,9.909197063,23.01169136,5.141787386,35.25501378,15.27654438,13.40897948,14.63814268,16.1,3.636834768,9.289671616,90527,0,0,1,1,3,4,0,1,1,3,4,0,0,0,0,0
6075,2018,320,883305,"California","San Francisco",14,2,12,10.1,10.15553353,23.89842064,5.042560057,35.42985485,15.21873676,13.56582427,14.82580404,18.1,3.252302657,6.273565808,101873,0,8,8,9,9,11,8,8,9,9,11,0,0,0,0,0
6075,2019,326,881549,"California","San Francisco",0,0,0,9.5,10.15553353,23.89842064,5.008689871,35.87316521,15.23186746,13.43758163,15.37208137,18.5,2.901065899,4.691426024,109601,0,14,22,22,23,23,2,10,10,11,11,12,12,12,12,12
6077,2015,409,726106,"California","San Joaquin",9,9,0,17.5,16.4,17.5,6.925391018,15.72718664,40.09091696,28.21208469,11.43446923,30.4,12.84106732,19.53330033,51219,8.472857381,9,25,29,38,40,9,22,25,33,35,0,3,4,5,5
6077,2016,351,733709,"California","San Joaquin",1,1,0,14.6,13.9,16.6,6.994998582,15.90965306,40.45098009,27.81230218,11.76779668,29.4,10.63907079,19.18834079,51527,8.472857381,9,18,34,38,47,9,18,31,34,42,0,0,3,4,5
6077,2017,275,745424,"California","San Joaquin",11,11,0,15.5,13.18818636,18.29475197,7.012612484,16.08153631,40.77173305,27.52958934,12.0614621,28.3,8.875586536,13.17068843,53341,8.472857381,1,10,19,35,39,1,10,19,32,35,0,0,0,3,4
6077,2018,254,752660,"California","San Joaquin",17,6,11,14.3,12.2277161,17.86570155,7.034805352,16.27688907,41.18144932,27.44453182,12.34563022,28,8.06079195,8.597790869,59038,8.472857381,11,12,21,30,46,11,12,21,30,43,0,0,0,0,3
6077,2019,269,762148,"California","San Joaquin",2,2,0,13.6,12.2277161,17.86570155,7.061350319,16.73450278,41.59605808,27.25079955,12.44929061,29.8,6.96207988,7.277928235,60950,8.472857381,17,28,29,38,47,6,17,18,27,36,11,11,11,11,11
6079,2015,157,281401,"California","San Luis Obispo",0,0,0,14.4,9.1,17.5,1.898402202,3.705284634,21.73178558,18.3488097,16.89715421,20.4,6.650550136,16.89376859,57743,16.59638699,0,0,0,0,0,0,0,0,0,0,0,0,0,0,0
6079,2016,187,282887,"California","San Luis Obispo",0,0,0,11,12.4,20.1,1.848554014,3.83613477,22.04397975,18.1447813,17.54925954,21.8,5.603975262,15.75839151,61775,16.59638699,0,0,0,0,0,0,0,0,0,0,0,0,0,0,0
6079,2017,190,283405,"California","San Luis Obispo",0,0,0,11.9,11.86399199,20.2715124,1.753725111,3.928557468,22.2159836,18.06567852,18.20569223,24.5,4.639445053,13.60450831,61761,16.59638699,0,0,0,0,0,0,0,0,0,0,0,0,0,0,0
6079,2018,125,284010,"California","San Luis Obispo",1,1,0,12.7,11.21189404,20.51184948,1.698204584,3.944331129,22.33117817,17.92341112,18.91638711,22.9,4.261746162,8.025895954,69517,16.59638699,0,0,0,0,0,0,0,0,0,0,0,0,0,0,0
6079,2019,130,283111,"California","San Luis Obispo",0,0,0,11.6,11.21189404,20.51184948,1.728268732,3.979111166,22.62768829,17.81619943,19.36910076,23.5,3.58213788,7.024096386,70634,16.59638699,1,1,1,1,1,1,1,1,1,1,0,0,0,0,0
6081,2015,319,765135,"California","San Mateo",0,0,0,8.4,10.5,20.6,2.485238295,26.8790818,25.37688678,21.68930374,14.34986279,20.8,5.397368962,13.05644755,91061,1.891012748,1,4,4,5,6,1,4,4,5,6,0,0,0,0,0
6081,2016,286,764797,"California","San Mateo",0,0,0,6.6,9.3,17.8,2.457351291,27.6500466,25.25808055,21.46112281,14.6597397,20.1,4.205646528,12.05239791,100806,1.891012748,0,1,4,4,5,0,1,4,4,5,0,0,0,0,0
6081,2017,294,771410,"California","San Mateo",7,5,2,6.4,8.66158863,17.96305828,2.413038222,28.2716122,25.14484372,21.20972116,14.96441804,21.1,3.394378753,9.147484722,101133,1.891012748,0,0,1,4,4,0,0,1,4,4,0,0,0,0,0
6081,2018,354,769545,"California","San Mateo",13,2,11,6.8,9.08424947,16.93582583,2.323361624,28.85654625,24.75284291,21.11959121,15.23986104,18.7,2.995182651,5.705427892,107075,1.891012748,7,7,7,8,11,5,5,5,6,9,2,2,2,2,2
6081,2019,325,766573,"California","San Mateo",0,0,0,6.1,9.08424947,16.93582583,2.281277142,29.61900935,24.49462672,20.77546311,15.77889838,21.3,2.678999657,5.214766952,115908,1.891012748,13,20,20,20,21,2,7,7,7,8,11,13,13,13,13
6083,2015,213,444769,"California","Santa Barbara",0,0,0,15.6,10.5,18,1.744101979,5.61743597,44.09348699,22.59184709,13.66041079,19.4,6.821590544,21.07110102,60803,5.01751613,0,0,0,0,0,0,0,0,0,0,0,0,0,0,0
6083,2016,233,446170,"California","Santa Barbara",0,0,0,13.9,12.4,18.2,1.766182251,5.733568128,44.4452513,22.38487932,13.97491989,19,6.080806141,21.06552749,62116,5.01751613,0,0,0,0,0,0,0,0,0,0,0,0,0,0,0
6083,2017,233,448150,"California","Santa Barbara",7,3,4,14.2,11.46675196,19.19457299,1.769008182,5.82774429,44.84822458,22.37948238,14.31529626,18.2,5.276339653,15.49168479,63049,5.01751613,0,0,0,0,0,0,0,0,0,0,0,0,0,0,0
6083,2018,248,446527,"California","Santa Barbara",1,1,0,12.6,11.1877815,19.44515153,1.786762893,5.881838761,45.1274178,22.39303405,14.64441805,20.5,5.006809002,12.22123938,66360,5.01751613,7,7,7,7,7,3,3,3,3,3,4,4,4,4,4
6083,2019,226,446499,"California","Santa Barbara",0,0,0,12,11.1877815,19.44515153,1.793819034,6.003570233,45.64520808,22.24991632,14.92513667,21,4.489891867,10.32545881,70651,5.01751613,1,8,8,8,8,1,4,4,4,4,0,4,4,4,4
6085,2015,97,1918044,"California","Santa Clara",1,1,0,8.3,10.3,14.9,2.395650794,34.10972154,26.75027027,23.3987866,11.965526,20.4,6.84032949,13.4207148,91843,1.083663272,1,2,2,3,3,1,2,2,3,3,0,0,0,0,0
6085,2016,117,1919402,"California","Santa Clara",0,0,0,9.3,9,15.9,2.405039573,34.90015069,26.55234205,23.10824684,12.22275883,19.5,5.198260548,12.57839127,97219,1.083663272,1,2,3,3,4,1,2,3,3,4,0,0,0,0,0
6085,2017,144,1938153,"California","Santa Clara",7,7,0,7.5,8.447803097,16.19525755,2.394991981,35.5991312,26.33286828,22.75218921,12.51154822,19.5,4.155116766,8.424815097,102191,1.083663272,0,1,2,3,3,0,1,2,3,3,0,0,0,0,0
6085,2018,515,1937570,"California","Santa Clara",13,2,11,7.3,8.199431207,15.92344763,2.360057976,36.50287954,25.91119526,22.56827908,12.77960532,19.7,3.762207448,5.943541342,110843,1.083663272,7,7,8,9,10,7,7,8,9,10,0,0,0,0,0
6085,2019,522,1927852,"California","Santa Clara",0,0,0,6.1,8.199431207,15.92344763,2.348524601,37.54951235,25.59240679,22.1902502,13.14256408,19.8,3.211257806,5.075513548,118468,1.083663272,13,20,20,21,22,2,9,9,10,11,11,11,11,11,11
6087,2015,87,274146,"California","Santa Cruz",0,0,0,15.4,10.1,20.5,0.966153092,4.758387493,32.94793611,20.48073818,12.80310594,21.5,9.475842337,18.39231222,65282,12.03931672,0,0,0,0,0,0,0,0,0,0,0,0,0,0,0
6087,2016,102,274673,"California","Santa Cruz",0,0,0,13.4,13.1,19.5,0.983797148,4.815970332,33.22725199,20.11817339,13.47441539,20.6,8.742445277,18.54166852,64257,12.03931672,0,0,0,0,0,0,0,0,0,0,0,0,0,0,0
6087,2017,93,275897,"California","Santa Cruz",2,2,0,12.6,11.47268974,20.29621238,0.978675596,5.049863941,33.30342226,19.76428618,14.15085393,20.2,7.498197549,12.89840505,64841,12.03931672,0,0,0,0,0,0,0,0,0,0,0,0,0,0,0
6087,2018,91,274255,"California","Santa Cruz",8,4,4,12.2,11.555175,19.96997787,0.973885311,4.930590193,33.52641141,19.66847852,14.91336972,18.2,6.899152396,7.807374769,75929,12.03931672,2,2,2,2,2,2,2,2,2,2,0,0,0,0,0
6087,2019,102,273213,"California","Santa Cruz",0,0,0,10.6,11.555175,19.96997787,0.945280304,5.034487508,33.92026735,19.46740994,15.62467153,17.4,5.670296658,7.146312621,76633,12.03931672,8,10,10,10,10,4,6,6,6,6,4,4,4,4,4
6089,2015,122,179533,"California","Shasta",1,1,0,19,25.1,19.6,0.882780199,2.794166946,9.125600626,21.68622192,18.75740306,27.3,10.92971811,18.99289695,41236,29.28626646,0,0,0,1,2,0,0,0,0,1,0,0,0,1,1
6089,2016,166,179631,"California","Shasta",0,0,0,17.2,14.1,18,0.93546306,2.972681364,9.410246713,21.58294587,19.2431759,27.2,9.664979194,18.00806642,43661,29.28626646,1,1,1,1,2,1,1,1,1,1,0,0,0,0,1
6089,2017,155,179921,"California","Shasta",1,0,1,17,13.65401267,17.20681121,0.963611147,3.037881615,9.626642456,21.5113656,19.84481962,26.5,7.804109113,13.49984698,45943,29.28626646,0,1,1,1,1,0,1,1,1,1,0,0,0,0,0
6089,2018,135,180040,"California","Shasta",8,2,6,15.2,14.31330477,18.66410197,0.945827836,3.006162633,9.77670892,21.49628962,20.35840139,24,6.917001339,8.560417807,46663,29.28626646,1,1,2,2,2,0,0,1,1,1,1,1,1,1,1
6089,2019,153,180080,"California","Shasta",0,0,0,13.3,14.31330477,18.66410197,0.984320896,3.144713513,10.10999272,21.53723023,20.31002496,22.7,5.801869059,6.731592693,51207,29.28626646,8,9,9,10,10,2,2,2,3,3,6,7,7,7,7
6093,2015,25,43554,"California","Siskiyou",3,3,0,22.6,23.8,19.5,1.374460604,1.299116418,11.57788991,20.310966,21.96168862,21.7,13.03969075,18.91259781,37108,65.82628062,2,4,6,6,6,1,3,3,3,3,1,1,3,3,3
6093,2016,25,43603,"California","Siskiyou",0,0,0,18.8,15.2,16.2,1.329421472,1.338589896,11.92124324,20.31951958,22.65746768,22.9,11.26604078,20.26999145,38641,65.82628062,3,5,7,9,9,3,4,6,6,6,0,1,1,3,3
6093,2017,27,43853,"California","Siskiyou",2,1,1,17.7,14.29573227,17.52011349,1.359232218,1.416632227,12.26523396,20.23465124,23.49037976,23.2,9.377767936,14.63370787,37447,65.82628062,0,3,5,7,9,0,3,4,6,6,0,0,1,1,3
6093,2018,24,43724,"California","Siskiyou",36,8,28,17.1,14.59513042,16.46142274,1.376052107,1.431094191,12.30878609,20.15686994,24.0854987,23.8,8.455656639,9.299781182,40875,65.82628062,2,2,5,7,9,1,1,4,5,7,1,1,1,2,2
6093,2019,28,43539,"California","Siskiyou",3,1,2,17.4,14.59513042,16.46142274,1.302077395,1.438898137,12.55102274,20.16509703,24.69842428,24.9,7.242665479,8.101133606,44013,65.82628062,36,38,38,41,43,8,9,9,12,13,28,29,29,29,30
6095,2015,192,436092,"California","Solano",3,3,0,12,13.5,18.3,13.87586278,15.41733759,25.21681403,23.28926429,12.9791802,26.5,8.419622531,15.19972767,63398,3.718452427,1,9,10,17,17,1,9,10,16,16,0,0,0,1,1
6095,2016,199,440207,"California","Solano",0,0,0,11.4,12.4,17.8,13.78119412,15.5908529,25.63536373,22.94499816,13.51700527,29.5,7.454861418,14.71449528,67106,3.718452427,3,4,12,13,20,3,4,12,13,19,0,0,0,0,1
6095,2017,214,445458,"California","Solano",9,5,4,10,11.58607642,19.07518002,13.72485622,15.65128459,26.0231786,22.78899865,14.10803225,30.1,6.12282434,10.25194451,67202,3.718452427,0,3,4,12,13,0,3,4,12,13,0,0,0,0,0
6095,2018,222,446610,"California","Solano",13,2,11,7.9,11.76509788,18.07655495,13.78896746,15.71828708,26.16450897,22.55234469,14.66446467,29.5,5.462233382,5.95949649,73200,3.718452427,9,9,12,13,21,5,5,8,9,17,4,4,4,4,4
6095,2019,215,447643,"California","Solano",0,0,0,9,11.76509788,18.07655495,13.75595455,16.06189585,26.53403912,22.27280686,15.17471905,27.4,4.752412774,6.132270002,75931,3.718452427,13,22,22,25,26,2,7,7,10,11,11,15,15,15,15
6097,2015,282,502146,"California","Sonoma",0,0,0,11,14,21.7,1.469016716,4.1373668,25.8544518,20.93550831,15.99575779,22.4,6.726932692,17.91640915,61020,12.35352713,0,0,0,0,0,0,0,0,0,0,0,0,0,0,0
6097,2016,275,503070,"California","Sonoma",0,0,0,9.4,11.6,17.5,1.504721243,4.288495519,26.10375541,20.63275047,16.68005885,21.6,5.577644338,17.19044834,66949,12.35352713,0,0,0,0,0,0,0,0,0,0,0,0,0,0,0
6097,2017,299,504217,"California","Sonoma",4,1,3,9.3,11.55566927,20.02245016,1.523461304,4.376217276,26.32640706,20.33671482,17.47121355,20.9,4.486371877,12.82482552,66463,12.35352713,0,0,0,0,0,0,0,0,0,0,0,0,0,0,0
6097,2018,277,499942,"California","Sonoma",13,2,11,9.9,11.15110372,19.33685809,1.52006679,4.351084342,26.56031964,20.04492417,18.24418073,20.3,3.952717877,8.651460624,73496,12.35352713,4,4,4,4,4,1,1,1,1,1,3,3,3,3,3
6097,2019,278,494336,"California","Sonoma",0,0,0,7.2,11.15110372,19.33685809,1.562224201,4.481205513,26.99234655,19.81448464,18.84585407,19.8,3.361782601,7.528047795,79511,12.35352713,13,17,17,17,17,2,3,3,3,3,11,14,14,14,14
6099,2015,239,538388,"California","Stanislaus",12,10,2,19.5,17.1,17,2.522783454,5.822935122,43.47933647,27.64176741,11.73226563,32.1,12.99103039,19.61913997,47808,7.980709608,20,59,76,105,121,12,37,51,68,82,8,22,25,37,39
6099,2016,276,541560,"California","Stanislaus",11,10,1,14.5,14.5,18.3,2.554901625,5.931048483,44.07017333,27.33643235,12.10965475,32.4,11.21782925,20.67672845,50917,7.980709608,12,32,71,88,117,10,22,47,61,78,2,10,24,27,39
6099,2017,347,547899,"California","Stanislaus",27,20,7,14,14.41828739,17.52639129,2.56004963,6.018336219,44.76622807,27.12969086,12.50473636,32.6,9.506406823,12.76797797,51949,7.980709608,11,23,43,82,99,10,20,32,57,71,1,3,11,25,28
6099,2018,276,549815,"California","Stanislaus",21,8,13,15.6,12.65945641,17.79377366,2.604328237,5.874695325,45.60916611,27.16541104,12.77033016,30.1,8.525562372,8.489093233,54060,7.980709608,27,38,50,70,109,20,30,40,52,77,7,8,10,18,32
6099,2019,306,550660,"California","Stanislaus",4,4,0,13,12.65945641,17.79377366,2.625848925,6.029943475,46.31802577,27.10809839,12.83375221,31.2,7.468086419,6.816877153,58925,7.980709608,21,48,59,71,91,8,28,38,48,60,13,20,21,23,31
6101,2015,15,96463,"California","Sutter",0,0,0,17.5,18.7,10.8,1.900367069,16.1688516,29.57315155,26.60199266,13.92343996,27.6,15.32165696,20.04910779,47903,14.79780867,3,5,7,15,16,3,5,7,14,14,0,0,0,1,2
6101,2016,43,96651,"California","Sutter",0,0,0,17.1,13.4,17.3,1.969806045,16.53781548,29.89034607,26.35554582,14.49288971,28,12.7162299,20.9294379,51827,14.79780867,0,3,5,7,15,0,3,5,7,14,0,0,0,0,1
6101,2017,49,96648,"California","Sutter",6,6,0,13.2,12.40715536,16.80223263,1.967593792,16.74735391,30.26445373,26.09290609,14.8678768,28.7,10.76209174,14.60368964,50810,14.79780867,0,0,3,5,7,0,0,3,5,7,0,0,0,0,0
6101,2018,63,96807,"California","Sutter",20,7,13,13.5,13.07124651,16.92000782,2.009291161,16.95999007,30.4611437,26.1290623,15.17728735,29.7,9.590310411,11.00917431,51283,14.79780867,6,6,6,9,11,6,6,6,9,11,0,0,0,0,0
6101,2019,35,96971,"California","Sutter",2,2,0,12.8,13.07124651,16.92000782,2.075573214,16.96879397,31.0394421,25.95708137,15.10533069,26.9,8.603161416,9.41040434,54102,14.79780867,20,26,26,26,29,7,13,13,13,16,13,13,13,13,13
6103,2015,22,63308,"California","Tehama",3,2,1,22.5,21.1,17.7,0.658134704,1.275036871,23.45655518,24.02429548,17.45404951,27.1,11.608,20.3420239,43459,51.48826876,0,0,3,4,4,0,0,3,4,4,0,0,0,0,0
6103,2016,37,63276,"California","Tehama",0,0,0,20.9,15.2,17.6,0.721454961,1.368386002,24.07122584,24.02365738,17.8175591,28.8,9.675247525,19.18319946,40782,51.48826876,3,3,3,6,7,2,2,2,5,6,1,1,1,1,1
6103,2017,46,63926,"California","Tehama",5,2,3,20.1,13.93319323,17.36146942,0.713969798,1.459531181,24.41081696,23.89745372,18.1351488,27.2,7.955537912,13.28019954,40292,51.48826876,0,3,3,3,6,0,2,2,2,5,0,1,1,1,1
6103,2018,32,63916,"California","Tehama",24,9,15,17,14.7413241,18.78625111,0.703268222,1.367026993,24.74871989,24.05493394,18.52993236,26.7,7.094956549,9.239597158,40585,51.48826876,5,5,8,8,8,2,2,4,4,4,3,3,4,4,4
6103,2019,35,65084,"California","Tehama",0,0,0,16.3,14.7413241,18.78625111,0.753996809,1.423520946,25.2416857,24.00431749,19.1142884,25.1,6.367684975,7.725651686,41819,51.48826876,24,29,29,32,32,9,11,11,13,13,15,18,18,19,19
6107,2015,99,459863,"California","Tulare",17,11,6,27.2,14.5,19.2,1.291223249,3.968573775,62.3264038,31.8142083,10.10871025,28.3,13.97262276,22.85043643,39657,15.47993007,31,65,81,108,116,14,37,48,69,76,17,28,33,39,40
6107,2016,136,460437,"California","Tulare",15,14,1,24.7,15.4,16.8,1.301184204,4.003945892,62.92192458,31.59682059,10.3937599,29.5,13.22653564,21.23652921,42360,15.47993007,17,48,82,98,125,11,25,48,59,80,6,23,34,39,45
6107,2017,140,464493,"California","Tulare",24,10,14,24,14.37818881,16.77967911,1.27711949,3.998799643,63.58502424,31.32150227,10.6873134,32.6,11.6627006,16.73544891,42637,15.47993007,15,32,63,97,113,14,25,39,62,73,1,7,24,35,40
6107,2018,187,465861,"California","Tulare",30,17,13,22.2,15.7733915,17.78235621,1.221231135,3.9644946,64.10171207,31.23358896,10.93526367,33.4,10.98883487,11.2012774,45768,15.47993007,24,39,56,87,121,10,24,35,49,72,14,15,21,38,49
6107,2019,194,466195,"California","Tulare",5,5,0,18.9,15.7733915,17.78235621,1.226713858,3.981976047,64.72584086,30.94255457,11.12374137,33.5,10.41801551,9.906887069,46377,15.47993007,30,54,69,86,117,17,27,41,52,66,13,27,28,34,51
6111,2015,411,850536,"California","Ventura",0,0,0,9.9,12.1,17.7,1.635263572,7.33307925,41.53343179,24.54253115,13.12236488,21.3,7.767110845,18.06564555,76513,3.124552117,0,0,0,0,0,0,0,0,0,0,0,0,0,0,0
6111,2016,391,849738,"California","Ventura",0,0,0,9.8,11.2,18.5,1.644098523,7.519812616,41.98301067,24.17552808,13.59052114,20.6,6.679921306,18.0687923,74967,3.124552117,0,0,0,0,0,0,0,0,0,0,0,0,0,0,0
6111,2017,430,854223,"California","Ventura",7,5,2,9.5,9.920187825,17.31042336,1.678118269,7.62260504,42.34529755,23.82603441,14.06125079,20.3,5.685414069,13.11606065,79285,3.124552117,0,0,0,0,0,0,0,0,0,0,0,0,0,0,0
6111,2018,423,850967,"California","Ventura",0,0,0,9.1,10.64246705,18.82616442,1.681341778,7.643414794,42.54417244,23.5790326,14.58484851,20.7,5.177600898,9.926899065,79470,3.124552117,7,7,7,7,7,5,5,5,5,5,2,2,2,2,2
6111,2019,440,846006,"California","Ventura",0,0,0,8.2,10.64246705,18.82616442,1.726481258,7.815172385,42.87709416,23.23163858,14.99784014,21,4.491734645,9.71544359,82436,3.124552117,0,7,7,7,7,0,5,5,5,5,0,2,2,2,2
6113,2015,103,213016,"California","Yolo",1,1,0,17.5,8.1,19,2.445342705,13.51903535,31.28699418,21.89664358,11.12745793,21.1,9.351901883,16.0640136,55011,6.929583916,0,0,0,5,6,0,0,0,5,6,0,0,0,0,0
6113,2016,89,215802,"California","Yolo",0,0,0,19,12.4,17.8,2.442795896,13.82436534,31.45479069,21.71251024,11.49380991,20.2,7.675910372,16.92526602,54509,6.929583916,1,1,1,1,6,1,1,1,1,6,0,0,0,0,0
6113,2017,98,219116,"California","Yolo",7,6,1,17.5,11.8787885,19.01543427,2.460378563,14.28390356,31.52955647,21.47303489,11.73339092,22.7,6.411021681,11.31071825,58766,6.929583916,0,1,1,1,1,0,1,1,1,1,0,0,0,0,0
6113,2018,91,220408,"California","Yolo",12,2,10,20.1,11.68360979,19.46963434,2.37532553,14.56752023,31.52287745,21.30239757,12.07403083,22.9,5.783327531,7.47569431,63645,6.929583916,7,7,8,8,8,6,6,7,7,7,1,1,1,1,1
6113,2019,107,220500,"California","Yolo",1,1,0,16.9,11.68360979,19.46963434,2.410595301,14.90352142,31.76490991,21.10799759,12.09176874,22.9,5.012294131,6.715084538,64900,6.929583916,12,19,19,20,20,2,8,8,9,9,10,11,11,11,11
41003,2015,26,87572,"Oregon","Benton",2,0,2,18.3,10.8,14,0.96430345,5.796214387,6.955688236,16.99368295,13.66654733,20.8,5.810823355,15.8781677,50714,18.7639491,1,3,3,3,3,1,3,3,3,3,0,0,0,0,0
41003,2016,35,89385,"Oregon","Benton",0,0,0,18.4,14.8,23.2,1.007924371,5.951387923,7.031141388,16.87520274,14.33685528,19.7,5.317554061,13.46699155,54089,18.7639491,2,3,5,5,5,0,1,3,3,3,2,2,2,2,2
41003,2017,35,90951,"Oregon","Benton",3,2,1,16,14.3641371,18.99288205,1.006029324,6.160644955,7.283149865,16.7622071,14.81067008,21.6,4.305859954,10.075953,54773,18.7639491,0,2,3,5,5,0,0,1,3,3,0,2,2,2,2
41003,2018,43,92101,"Oregon","Benton",2,2,0,15.8,14.02861236,20.35584326,1.070649438,6.498853275,7.283101192,16.50500643,15.23298093,24.4,3.917846784,7.081791502,56167,18.7639491,3,3,5,6,8,2,2,2,3,5,1,1,3,3,3
41003,2019,41,93053,"Oregon","Benton",0,0,0,16.5,14.02861236,20.35584326,1.096194654,6.687117239,7.464458885,16.5407747,15.63149388,26.5,3.262269875,6.643808667,60572,18.7639491,2,5,5,7,8,2,4,4,4,5,0,1,1,3,3
41005,2015,179,401515,"Oregon","Clackamas",2,0,2,9.4,14.6,16.6,0.845303312,3.99600271,8.148857862,22.48939508,15.58917538,26.2,6.837990422,13.9532006,66514,18.07857614,2,2,2,2,2,2,2,2,2,2,0,0,0,0,0
41005,2016,190,408062,"Oregon","Clackamas",0,0,0,8.7,12.6,20.6,0.856769594,4.224603263,8.35350354,22.22106884,16.15203103,25.5,6.284098503,13.7828423,65555,18.07857614,2,4,4,4,4,0,2,2,2,2,2,2,2,2,2
41005,2017,183,412672,"Oregon","Clackamas",4,3,1,8.3,13.96636879,21.25111808,0.889132411,4.364718628,8.520478687,22.00241585,16.68829309,25.3,5.208796905,9.637629033,69523,18.07857614,0,2,4,4,4,0,0,2,2,2,0,2,2,2,2
41005,2018,166,416075,"Oregon","Clackamas",4,2,2,7.3,12.98750992,20.77303218,0.920448363,4.378501306,8.433767418,21.80036367,17.18807436,27.2,4.44153381,6.192752901,74460,18.07857614,4,4,6,8,8,3,3,3,5,5,1,1,3,3,3
41005,2019,233,418187,"Oregon","Clackamas",0,0,0,7.2,12.98750992,20.77303218,0.950149271,4.618195565,8.6543308,21.74414547,17.4465435,28.1,3.741088026,5.759200699,79404,18.07857614,4,8,8,10,12,2,5,5,5,7,2,3,3,5,5
41009,2015,21,49600,"Oregon","Columbia",1,1,0,13.4,19.3,16.1,0.500567445,0.993028534,4.630755512,22.69374189,16.43360895,30.3,8.243421894,14.9678671,55222,43.61208486,0,0,0,0,0,0,0,0,0,0,0,0,0,0,0
41009,2016,16,50785,"Oregon","Columbia",0,0,0,11,16.2,20,0.556016094,1.045310257,4.638185164,22.35993449,17.13742696,32.1,8.401431159,14.2088267,57517,43.61208486,1,1,1,1,1,1,1,1,1,1,0,0,0,0,0
41009,2017,17,51782,"Oregon","Columbia",4,3,1,12.3,14.9997733,18.64615304,0.512096774,1.151209677,4.77016129,21.98790323,17.76209677,33.8,7.210866527,9.533274441,52060,43.61208486,0,1,1,1,1,0,1,1,1,1,0,0,0,0,0
41009,2018,20,52377,"Oregon","Columbia",5,5,0,10.2,15.29471078,19.39378392,0.513931279,1.147976765,4.901053461,21.46696859,18.14118342,32,6.214352601,7.05740449,63055,43.61208486,4,4,5,5,5,3,3,4,4,4,1,1,1,1,1
41009,2019,11,52354,"Oregon","Columbia",0,0,0,8.6,15.29471078,19.39378392,0.573558379,1.108493299,5.22382295,21.45533197,18.27275887,33.1,5.172556143,6.331956821,61453,43.61208486,5,9,9,10,10,5,8,8,9,9,0,1,1,1,1
41017,2015,75,175268,"Oregon","Deschutes",3,2,1,13.4,12.3,16.8,0.398303144,1.043662702,7.678633838,21.84701785,17.4415802,23,9.478855849,18.280147,49427,27.64354954,0,0,15,16,16,0,0,6,7,7,0,0,9,9,9
41017,2016,90,181307,"Oregon","Deschutes",0,0,0,10.6,14.9,20.5,0.401436721,1.099255816,7.796323685,21.33600958,18.2935418,23.3,7.890540992,18.68326617,52387,27.64354954,3,3,3,18,19,2,2,2,8,9,1,1,1,10,10
41017,2017,80,186875,"Oregon","Deschutes",27,5,22,9.7,15.56307835,20.34608622,0.430198325,1.137115731,7.892484652,21.06887738,18.89506356,24.1,5.967808992,11.97403048,56911,27.64354954,0,3,3,3,18,0,2,2,2,8,0,1,1,1,10
41017,2018,115,191996,"Oregon","Deschutes",12,8,4,9.4,13.71079669,20.5458413,0.455029315,1.14336457,7.793411176,20.70686736,19.34619182,22.6,4.90088167,8.641415929,61248,27.64354954,27,27,30,30,30,5,5,7,7,7,22,22,23,23,23
41017,2019,85,197692,"Oregon","Deschutes",1,1,0,9.2,13.71079669,20.5458413,0.442541806,1.186889632,8.015518395,20.48695652,19.40816054,22.9,4.212046646,7.857495814,65506,27.64354954,12,39,39,42,42,8,13,13,15,15,4,26,26,27,27
41019,2015,50,107685,"Oregon","Douglas",1,0,1,19.5,24.1,14.5,0.340377782,1.102487376,5.086029549,19.54740976,23.10734992,34.3,10.82232046,17.544451,40243,41.17789109,0,0,0,0,0,0,0,0,0,0,0,0,0,0,0
41019,2016,59,108457,"Oregon","Douglas",0,0,0,15.6,17.5,19,0.36551621,1.084395917,5.242493363,19.5228658,23.60617732,31,9.415701881,17.40805047,41504,41.17789109,1,1,1,1,1,0,0,0,0,0,1,1,1,1,1
41019,2017,69,109405,"Oregon","Douglas",8,4,4,14.9,16.56301725,18.85811991,0.395598273,1.106003622,5.598737057,19.42703255,24.18814134,31,7.655632132,11.74989198,41696,41.17789109,0,1,1,1,1,0,0,0,0,0,0,1,1,1,1
41019,2018,65,110283,"Oregon","Douglas",2,2,0,15,15.85536623,16.65013559,0.395548466,1.061250081,5.598532137,19.35790221,24.68812525,29.7,6.38905232,8.141023251,43202,41.17789109,8,8,9,9,9,4,4,4,4,4,4,4,5,5,5
41019,2019,59,110980,"Oregon","Douglas",0,0,0,11.8,15.85536623,16.65013559,0.424112244,1.062108679,5.874502994,19.38302637,25.09848727,32.6,5.350854591,7.504769981,47157,41.17789109,2,10,10,11,11,2,6,6,6,6,0,4,4,5,5
41029,2015,121,212567,"Oregon","Jackson",21,11,10,19.3,18.6,14.2,0.666522813,1.369968112,11.69339951,21.23954063,19.45623247,24.7,9.511965445,19.70869751,43393,20.0525575,0,14,14,14,14,0,7,7,7,7,0,7,7,7,7
41029,2016,110,216527,"Oregon","Jackson",0,0,0,14.6,17.8,21.3,0.688582746,1.381920899,12.04211387,20.95707295,20.16006696,25.1,8.605206789,19.78557798,44835,20.0525575,21,21,35,35,35,11,11,18,18,18,10,10,17,17,17
41029,2017,147,217479,"Oregon","Jackson",20,4,16,14.3,17.11907829,18.11599882,0.71836174,1.402381367,12.36598343,20.85554202,20.81414331,25.6,6.913608062,12.91369358,44855,20.0525575,0,21,21,35,35,0,11,11,18,18,0,10,10,17,17
41029,2018,122,219564,"Oregon","Jackson",38,12,26,14.8,17.68916138,20.68607079,0.737090525,1.459864128,12.47881327,20.6297598,21.26663188,26.6,5.788201541,8.8692238,48538,20.0525575,20,20,41,41,55,4,4,15,15,22,16,16,26,26,33
41029,2019,132,220944,"Oregon","Jackson",4,1,3,13.6,17.68916138,20.68607079,0.73800229,1.500374749,12.89549796,20.71004557,21.51472096,26.2,4.770470987,8.017293143,51364,20.0525575,38,58,58,79,79,12,16,16,27,27,26,42,42,52,52
41033,2015,29,84745,"Oregon","Josephine",3,1,2,21.9,23.5,13.9,0.414135837,0.944709865,6.803831657,19.71046503,24.29476868,25.9,10.91159376,17.97126246,37619,44.96391136,0,12,12,12,12,0,1,1,1,1,0,11,11,11,11
41033,2016,46,85904,"Oregon","Josephine",0,0,0,18,17,18.1,0.454550892,0.971303485,7.00127992,19.55765021,24.83283293,26.3,9.643128322,17.10530513,37230,44.96391136,3,3,15,15,15,1,1,2,2,2,2,2,13,13,13
41033,2017,48,86352,"Oregon","Josephine",17,2,15,17.8,19.35865034,17.01450528,0.45666411,1.012449112,7.257065314,19.53389581,25.18496667,27.1,7.855376636,12.02597778,40569,44.96391136,0,3,3,15,15,0,1,1,2,2,0,2,2,13,13
41033,2018,35,87393,"Oregon","Josephine",29,12,17,17,18.33355763,16.58147554,0.451666977,0.984820265,7.289532501,19.58116037,25.60067052,27.8,6.557377049,8.857711571,38921,44.96391136,17,17,20,20,32,2,2,3,3,4,15,15,17,17,28
41033,2019,48,87487,"Oregon","Josephine",4,2,2,15.9,18.33355763,16.58147554,0.457430054,1.050352047,7.497220678,19.60232537,25.41342413,29.5,5.382572333,7.932461035,43492,44.96391136,29,46,46,49,49,12,14,14,15,15,17,32,32,34,34
41035,2015,30,66016,"Oregon","Klamath",8,7,1,19.9,22.6,13.6,0.663025338,1.043847671,11.64011531,21.62190866,18.71187984,29.1,10.74900536,20.33717136,37542,37.58059657,3,22,26,34,36,3,14,18,26,28,0,8,8,8,8
41035,2016,32,66443,"Oregon","Klamath",0,0,0,19,17.6,19.1,0.714995035,1.029715071,11.89213964,21.49262852,19.20403331,29,9.661987569,20.30809409,39234,37.58059657,8,11,30,34,42,7,10,21,25,33,1,1,9,9,9
41035,2017,21,66935,"Oregon","Klamath",26,14,12,19.2,18.57400223,19.19697097,0.786173049,1.040656811,12.23188318,21.64020843,19.82246728,29.9,7.991140487,13.41148841,42384,37.58059657,0,8,11,30,34,0,7,10,21,25,0,1,1,9,9
41035,2018,28,67653,"Oregon","Klamath",39,10,29,18.5,17.57638561,18.35933183,0.75402977,1.095675993,12.5265265,21.67873215,20.3287028,31.2,6.861279141,10.26340746,44678,37.58059657,26,26,34,37,56,14,14,21,24,35,12,12,13,13,21
41035,2019,15,68238,"Oregon","Klamath",0,0,0,16.7,17.57638561,18.35933183,0.746993352,1.178755509,13.14857698,21.60005976,20.77687309,31.8,5.890227577,9.46647735,41875,37.58059657,39,65,65,73,76,10,24,24,31,34,29,41,41,42,42
41039,2015,210,362895,"Oregon","Lane",2,0,2,19,17.5,16.9,0.907886315,2.768295285,7.985974644,19.13439188,16.77821073,28.1,7.637853301,17.68258691,43778,17.52299447,0,4,4,4,4,0,4,4,4,4,0,0,0,0,0
41039,2016,280,369519,"Oregon","Lane",0,0,0,18.3,15.4,21.5,0.931246285,2.8827612,8.282985011,19.09180464,17.39535689,27.3,7.069306346,18.30962199,44976,17.52299447,2,2,6,6,6,0,0,4,4,4,2,2,2,2,2
41039,2017,288,374748,"Oregon","Lane",12,4,8,16.6,15.84447283,19.59512164,0.966395238,3.009410436,8.476005456,18.95837639,17.90407694,27.4,5.947907672,11.96443704,47254,17.52299447,0,2,2,6,6,0,0,0,4,4,0,2,2,2,2
41039,2018,289,379611,"Oregon","Lane",1,1,0,18.1,15.20904378,19.28400933,0.989394321,3.018789291,8.549222097,18.80769324,18.47509871,27.3,5.149462738,8.793604901,47933,17.52299447,12,12,14,14,18,4,4,4,4,8,8,8,10,10,10
41039,2019,317,382067,"Oregon","Lane",0,0,0,13.9,15.20904378,19.28400933,1.019084825,3.101817755,8.90945382,18.70323524,18.73418938,27.6,4.450682295,8.084090344,50711,17.52299447,1,13,13,15,15,1,5,5,5,5,0,8,8,10,10
41043,2015,76,120547,"Oregon","Linn",3,1,2,15.8,20.2,16.7,0.467309393,1.103018566,8.229697301,23.49766345,16.78019619,31.3,9.709412627,16.63861456,44941,31.63826797,0,0,0,1,1,0,0,0,0,0,0,0,0,1,1
41043,2016,56,122849,"Oregon","Linn",0,0,0,13.1,17,20.1,0.48091424,1.12185395,8.355675458,23.17269346,17.29950736,32.3,8.367271381,15.9429293,44358,31.63826797,3,3,3,3,4,1,1,1,1,1,2,2,2,2,3
41043,2017,64,125047,"Oregon","Linn",7,2,5,14.3,17.34715877,18.1727236,0.518469974,1.129849768,8.683749907,23.05407849,17.69600239,33.6,6.885438031,10.31993219,47757,31.63826797,0,3,3,3,3,0,1,1,1,1,0,2,2,2,2
41043,2018,63,127335,"Oregon","Linn",1,1,0,12.7,16.39027648,16.29128963,0.536430903,1.155076557,8.831980724,22.81744255,18.11166554,35.6,5.758896532,8.320320075,50876,31.63826797,7,7,10,10,10,2,2,3,3,3,5,5,7,7,7
41043,2019,66,129749,"Oregon","Linn",0,0,0,12.6,16.39027648,16.29128963,0.569385911,1.161963102,9.112573672,22.8146217,18.26993051,35.4,4.763957378,7.224526455,51888,31.63826797,1,8,8,11,11,1,3,3,4,4,0,5,5,7,7
41047,2015,98,330700,"Oregon","Marion",2,0,2,16.8,15.1,12.2,1.026531609,2.204787185,25.29278709,25.61508464,13.92090577,33.9,8.395006453,20.76081681,46919,13.09369401,1,6,6,6,6,0,5,5,5,5,1,1,1,1,1
41047,2016,109,336316,"Oregon","Marion",0,0,0,13.6,15.4,18.4,1.033086995,2.262733434,25.68673147,25.42976296,14.40280887,33.3,7.48688507,19.01058729,48554,13.09369401,2,3,8,8,8,0,0,5,5,5,2,3,3,3,3
41047,2017,112,341286,"Oregon","Marion",3,2,1,15.2,14.67968385,17.28976192,1.02691261,2.282128818,25.96613245,25.14302994,14.78832779,34.1,6.097769029,13.50865288,51623,13.09369401,0,2,3,8,8,0,0,0,5,5,0,2,3,3,3
41047,2018,87,346868,"Oregon","Marion",6,6,0,14.5,15.7874285,17.47266397,1.035633155,2.367119019,26.21701019,24.98602505,15.12268224,32.9,5.110336085,9.715578682,55954,13.09369401,3,3,5,6,11,2,2,2,2,7,1,1,3,4,4
41047,2019,110,347818,"Oregon","Marion",0,0,0,12.2,15.7874285,17.47266397,1.085013742,2.410881196,26.65975165,24.84338649,15.25406844,34.1,4.303477993,9.106736989,56148,13.09369401,6,9,9,11,12,6,8,8,8,8,0,1,1,3,4
41051,2015,282,790294,"Oregon","Multnomah",2,0,2,15.7,13.5,19.2,5.280400974,7.010383288,11.10000196,19.9344763,11.57420037,22.1,6.89219238,17.28367297,53624,1.342247197,0,4,4,8,8,0,4,4,8,8,0,0,0,0,0
41051,2016,253,799766,"Oregon","Multnomah",0,0,0,14.2,16.6,24,5.297072789,7.224814346,11.20350915,19.75082141,11.92269464,20.5,6.056311234,17.32673044,53519,1.342247197,2,2,6,6,10,0,0,4,4,8,2,2,2,2,2
41051,2017,248,807555,"Oregon","Multnomah",6,2,4,14.4,15.52867985,22.91666665,5.343327926,7.498095645,11.29200019,19.56347891,12.2316505,21.3,4.992295263,11.07721413,58764,1.342247197,0,2,2,6,6,0,0,0,4,4,0,2,2,2,2
41051,2018,287,811880,"Oregon","Multnomah",6,5,1,12,15.06974227,22.05507768,5.440966483,7.502944611,11.35594661,19.33040414,12.58368073,22.2,4.285147823,8.19232299,62292,1.342247197,6,6,8,8,12,2,2,2,2,6,4,4,6,6,6
41051,2019,285,812855,"Oregon","Multnomah",0,0,0,12,15.06974227,22.05507768,5.601723722,7.866089616,11.57271022,19.10916284,13.00295336,22.7,3.632497796,7.257111935,63587,1.342247197,6,12,12,14,14,5,7,7,7,7,1,5,5,7,7
41059,2015,21,76531,"Oregon","Umatilla",5,2,3,19.2,21.7,14.6,0.750782065,1.117049009,25.17726799,25.97106361,13.69134515,33,8.147954516,20.7421262,47053,29.06613607,0,5,5,6,6,0,5,5,6,6,0,0,0,0,0
41059,2016,29,76456,"Oregon","Umatilla",0,0,0,15.7,16.8,19.9,0.808291506,1.130304413,25.74147709,25.84577277,14.11120527,32.1,7.914888807,20.09432454,44780,29.06613607,5,5,10,10,11,2,2,7,7,8,3,3,3,3,3
41059,2017,28,76985,"Oregon","Umatilla",10,7,3,15.6,17.27676471,19.48187218,0.84802237,1.165540761,26.0587213,25.87186892,14.38502045,31.8,6.50073872,13.344412,49016,29.06613607,0,5,5,10,10,0,2,2,7,7,0,3,3,3,3
41059,2018,43,77516,"Oregon","Umatilla",8,4,4,15.8,18.30977887,18.4656632,0.865857487,1.124829968,26.37726274,25.72198389,14.78366642,33.4,5.417321099,11.49595775,49667,29.06613607,10,10,15,15,20,7,7,9,9,14,3,3,6,6,6
41059,2019,31,77950,"Oregon","Umatilla",1,1,0,13.9,18.30977887,18.4656632,0.883288952,1.131389232,26.81821134,25.42443333,15.19127103,34.9,4.834254144,10.14378311,51586,29.06613607,8,18,18,23,23,4,11,11,13,13,4,7,7,10,10
41067,2015,193,574326,"Oregon","Washington",2,1,1,10.5,11.9,15.2,1.796229162,9.559348176,16.13975596,24.64792539,11.43035265,25.6,6.279750629,14.92392986,63632,5.590039833,0,6,6,7,8,0,6,6,7,8,0,0,0,0,0
41067,2016,205,582779,"Oregon","Washington",0,0,0,9,12.1,20.9,1.857200203,9.897193241,16.28265109,24.33294612,11.85883431,24.4,5.723150065,14.88723942,66315,5.590039833,2,2,8,8,9,1,1,7,7,8,1,1,1,1,1
41067,2017,202,588957,"Oregon","Washington",7,6,1,8,12.3166474,20.49118214,1.921904981,10.08904351,16.44466731,23.95225012,12.20683027,24,4.770952855,10.66996659,70417,5.590039833,0,2,2,8,8,0,1,1,7,7,0,1,1,1,1
41067,2018,199,597695,"Oregon","Washington",6,5,1,8.8,12.51774341,20.85053826,1.940014997,10.45319066,16.48000357,23.60225746,12.60941112,25.9,4.165592404,7.667478915,75577,5.590039833,7,7,9,9,15,6,6,7,7,13,1,1,2,2,2
41067,2019,222,601592,"Oregon","Washington",0,0,0,8.2,12.51774341,20.85053826,2.030538732,10.93305623,16.80937658,23.26944072,12.93523975,28.5,3.49945205,6.001162225,80845,5.590039833,6,13,13,15,15,5,11,11,12,12,1,2,2,3,3
53005,2015,145,190309,"Washington","Benton",3,3,0,14.2,15.3,13.4,1.320425398,2.948191191,19.92346303,26.87792028,12.88986698,32,8.347211108,14.92422183,59264,10.57102245,0,0,1,1,1,0,0,1,1,1,0,0,0,0,0
53005,2016,151,193686,"Washington","Benton",0,0,0,10.5,13.8,20.6,1.34755424,2.970732387,20.42727068,26.66205506,13.39617987,31.4,7.658628737,16.38129361,58750,10.57102245,3,3,3,4,4,3,3,3,4,4,0,0,0,0,0
53005,2017,143,198171,"Washington","Benton",10,5,5,12,13.73291907,20.43814744,1.396675932,3.144885423,20.95591906,26.74545082,13.77233867,31.5,6.575013639,10.91026226,62698,10.57102245,0,3,3,3,4,0,3,3,3,4,0,0,0,0,0
53005,2018,122,201877,"Washington","Benton",7,4,3,9.8,13.41682884,20.11884252,1.372324277,3.197443285,21.40371529,26.78407319,14.11976085,29.5,6.54816101,7.374015433,63474,10.57102245,10,10,13,13,13,5,5,8,8,8,5,5,5,5,5
53005,2019,126,204390,"Washington","Benton",0,0,0,10.6,13.41682884,20.11884252,1.456318028,3.120537314,21.90330573,26.78948989,14.44055891,29.8,5.50138561,7.341451996,64717,10.57102245,7,17,17,20,20,4,9,9,12,12,3,8,8,8,8
53007,2015,86,75644,"Washington","Chelan",3,1,2,12.7,13.2,14.5,0.532669974,1.101842714,27.12155421,24.40277421,16.96026607,25.8,7.256600976,19.96330095,50033,27.22454557,6,6,24,25,25,5,5,9,10,10,1,1,15,15,15
53007,2016,83,76338,"Washington","Chelan",0,0,0,11.5,14,18.9,0.510806028,1.165066767,27.41325682,24.23580201,17.46125382,26.4,6.354980469,21.04329253,49174,27.22454557,3,9,9,27,28,1,6,6,10,11,2,3,3,17,17
53007,2017,92,76533,"Washington","Chelan",17,5,12,13.3,13.14002304,16.78676703,0.563164296,1.155412194,27.73253662,24.04685104,17.90888901,26.7,5.460298258,13.35555702,53604,27.22454557,0,3,9,9,27,0,1,6,6,10,0,2,3,3,17
53007,2018,98,77036,"Washington","Chelan",20,8,12,10.9,14.0137759,18.78662096,0.548874741,1.236605622,27.65726113,23.85050696,18.40367838,26.7,5.870164173,9.689783403,51930,27.22454557,17,17,20,26,26,5,5,6,11,11,12,12,14,15,15
53007,2019,101,77200,"Washington","Chelan",0,0,0,12.2,14.0137759,18.78662096,0.654619576,1.267427123,28.12642912,23.88120157,18.37246678,25.2,4.872186531,9.723037777,57284,27.22454557,20,37,37,40,46,8,13,13,14,19,12,24,24,26,27
53009,2015,56,73486,"Washington","Clallam",0,0,0,15.6,18.9,13.8,0.882287864,1.623520301,5.689235535,17.86702069,26.01228012,28.1,9.20769315,18.69548657,46531,35.4531959,0,0,0,0,0,0,0,0,0,0,0,0,0,0,0
53009,2016,47,74570,"Washington","Clallam",0,0,0,15.3,13.8,17.7,0.906277934,1.723165784,5.815856426,17.65247886,26.87065942,27.3,8.597201084,18.24055192,47185,35.4531959,0,0,0,0,0,0,0,0,0,0,0,0,0,0,0
53009,2017,73,75474,"Washington","Clallam",3,1,2,16.4,14.89986855,16.42171761,0.885883025,1.671066598,6.014751109,17.52714803,27.62158779,26.3,7.994933314,13.25821054,46708,35.4531959,0,0,0,0,0,0,0,0,0,0,0,0,0,0,0
53009,2018,77,76737,"Washington","Clallam",5,1,4,13.3,13.54605582,16.50768971,0.893120558,1.656161995,6.102990479,17.3555049,28.34249698,25.4,7.912568306,9.494855908,49502,35.4531959,3,3,3,3,3,1,1,1,1,1,2,2,2,2,2
53009,2019,81,77331,"Washington","Clallam",0,0,0,11.2,13.54605582,16.50768971,0.922171874,1.813869677,6.331981875,17.34902086,28.79137186,27.3,6.817774913,8.856145494,49070,35.4531959,5,8,8,8,8,1,2,2,2,2,4,6,6,6,6
53011,2015,214,459495,"Washington","Clark",4,3,1,10.6,15.3,16,1.918132924,4.545116568,8.375298828,25.64773319,13.18764266,29.4,9.603431461,15.70174978,57886,13.7684754,1,7,7,11,11,1,7,7,11,11,0,0,0,0,0
53011,2016,214,467018,"Washington","Clark",0,0,0,9,14.2,19.1,1.945198311,4.624751667,8.671686533,25.23480737,13.75807081,30,7.852222738,15.21961105,61747,13.7684754,4,5,11,11,15,3,4,10,10,14,1,1,1,1,1
53011,2017,190,474643,"Washington","Clark",5,3,2,10.2,14.72255447,18.84461033,1.97782348,4.74042155,9.039924265,24.92649539,14.21625915,29.9,6.357504216,10.27850068,64282,13.7684754,0,4,5,11,11,0,3,4,10,10,0,1,1,1,1
53011,2018,245,481857,"Washington","Clark",4,4,0,8.8,14.25176367,18.03405535,1.976797468,4.629586012,9.316557392,24.63823664,14.72555662,28.5,6.254079635,6.941315885,68937,13.7684754,5,5,9,10,16,3,3,6,7,13,2,2,3,3,3
53011,2019,248,488241,"Washington","Clark",0,0,0,9.2,14.25176367,18.03405535,2.010774414,4.819833011,9.652517787,24.31722368,14.94323102,28.4,5.101547176,6.537181022,74243,13.7684754,4,9,9,13,14,4,7,7,10,11,0,2,2,3,3
53015,2015,68,103468,"Washington","Cowlitz",1,1,0,15.7,23.2,18.6,0.666601217,1.630669546,8.231886904,23.16905557,17.64578834,34.6,10.12414126,16.03963921,48447,28.65149888,0,0,0,0,0,0,0,0,0,0,0,0,0,0,0
53015,2016,45,105160,"Washington","Cowlitz",0,0,0,16.3,17,19.4,0.7343366,1.621415214,8.418434786,22.92892601,18.13126022,32.4,8.3931166,16.99797501,44235,28.65149888,1,1,1,1,1,1,1,1,1,1,0,0,0,0,0
53015,2017,66,106910,"Washington","Cowlitz",2,0,2,16.4,17.37523153,18.07395177,0.710364557,1.6575173,8.630687749,22.73649824,18.4849422,32.1,7.586502846,11.22466196,50502,28.65149888,0,1,1,1,1,0,1,1,1,1,0,0,0,0,0
53015,2018,58,108987,"Washington","Cowlitz",4,2,2,12.2,17.00447249,18.73140656,0.793077216,1.647014074,8.789463674,22.66165843,18.83605934,31.9,7.485677345,7.99841829,51772,28.65149888,2,2,3,3,3,0,0,1,1,1,2,2,2,2,2
53015,2019,62,110593,"Washington","Cowlitz",0,0,0,12.6,17.00447249,18.73140656,0.844635675,1.629407913,9.031895987,22.922084,18.65962024,31.3,6.05520539,7.157469077,50617,28.65149888,4,6,6,7,7,2,2,2,3,3,2,4,4,4,4
53021,2015,41,88807,"Washington","Franklin",4,3,1,15.6,11.7,14.4,1.984117824,2.148018191,51.40238694,33.71153535,7.72640181,31,9.263518212,22.43921569,52720,13.3336745,0,0,1,1,1,0,0,1,1,1,0,0,0,0,0
53021,2016,34,90160,"Washington","Franklin",0,0,0,14.9,15.3,19.4,2.01459987,2.129622248,51.85345466,33.46923436,7.920600394,31.5,8.46540091,22.98340534,55006,13.3336745,4,4,4,5,5,3,3,3,4,4,1,1,1,1,1
53021,2017,40,92125,"Washington","Franklin",9,3,6,13.4,15.8464637,18.48740313,1.932280113,2.186764557,52.39339241,33.10324637,8.288761021,30.1,7.483569522,17.46238109,58246,13.3336745,0,4,4,4,5,0,3,3,3,4,0,1,1,1,1
53021,2018,40,94347,"Washington","Franklin",7,4,3,13.4,15.0569929,18.27871,2.108473824,2.299245785,53.02573203,33.13110027,8.585847382,30.7,7.645925592,12.6054954,56940,13.3336745,9,9,13,13,13,3,3,6,6,6,6,6,7,7,7
53021,2019,31,95222,"Washington","Franklin",0,0,0,13.5,15.0569929,18.27871,2.036363636,2.431478969,53.28195387,32.52971506,8.943283582,30.5,6.309788858,11.82661434,61285,13.3336745,7,16,16,20,20,4,7,7,10,10,3,9,9,10,10
53025,2015,35,93259,"Washington","Grant",4,2,2,16.1,16.1,13.9,0.85874747,1.109079431,39.38157121,30.53179216,12.44585211,33.4,8.80222574,22.05657397,46065,38.74887792,1,1,1,1,1,1,1,1,1,1,0,0,0,0,0
53025,2016,35,93546,"Washington","Grant",0,0,0,16.1,16.4,19.2,0.865298936,1.145501197,39.90037253,30.19528273,12.62735246,35,7.652855543,22.76724668,50388,38.74887792,4,5,5,5,5,2,3,3,3,3,2,2,2,2,2
53025,2017,44,95158,"Washington","Grant",12,6,6,14.7,16.23804538,17.8924479,0.841741816,1.105523328,40.42612509,30.0668032,12.92636636,34.3,7.084450697,16.65297997,50573,38.74887792,0,4,5,5,5,0,2,3,3,3,0,2,2,2,2
53025,2018,40,97331,"Washington","Grant",10,4,6,12.7,15.94432996,17.68062758,0.915057833,1.044405961,41.00656362,29.82703697,13.26833857,34.4,7.411788337,13.6449676,48997,38.74887792,12,12,16,17,17,6,6,8,9,9,6,6,8,8,8
53025,2019,44,97733,"Washington","Grant",0,0,0,13.9,15.94432996,17.68062758,0.900607411,1.048782026,41.7001198,29.68851804,13.5259253,34.7,6.256896932,11.53326685,55807,38.74887792,10,22,22,26,27,4,10,10,12,13,6,12,12,14,14
53027,2015,40,71122,"Washington","Grays Harbor",0,0,0,16,22.8,21.5,1.225414334,1.506795352,9.592278905,21.09513492,18.21660711,34.6,11.82830931,20.10941034,41791,40.11291674,0,0,0,0,0,0,0,0,0,0,0,0,0,0,0
53027,2016,57,71628,"Washington","Grays Harbor",0,0,0,15.2,17.5,18.3,1.253918495,1.481261826,9.816713265,21.08079867,18.92880341,36.5,10.36080406,21.71210799,43205,40.11291674,0,0,0,0,0,0,0,0,0,0,0,0,0,0,0
53027,2017,56,72697,"Washington","Grays Harbor",1,0,1,18.3,18.69990751,17.96988516,1.240122606,1.511487304,10.13188606,20.87399117,19.61277804,36.9,8.948678881,14.36343852,44345,40.11291674,0,0,0,0,0,0,0,0,0,0,0,0,0,0,0
53027,2018,35,73901,"Washington","Grays Harbor",3,0,3,17.3,16.95007108,18.32014242,1.221589323,1.48126431,9.860669012,20.76562238,20.19461663,34.9,8.709312096,10.34375571,48210,40.11291674,1,1,1,1,1,0,0,0,0,0,1,1,1,1,1
53027,2019,52,75061,"Washington","Grays Harbor",0,0,0,13.1,16.95007108,18.32014242,1.229761888,1.453980219,10.00453939,20.5496788,20.9210834,36.6,7.071609882,8.014347466,47619,40.11291674,3,4,4,4,4,0,0,0,0,0,3,4,4,4,4
53031,2015,14,30466,"Washington","Jefferson",0,0,0,11.9,14.7,15.5,1.000797979,1.815400984,3.285011305,13.7850778,30.48610188,25.3,8.955093482,16.53012048,47709,57.46853241,0,0,0,0,0,0,0,0,0,0,0,0,0,0,0
53031,2016,14,31139,"Washington","Jefferson",0,0,0,12,12.5,16.3,0.97922456,1.829429668,3.658859336,13.40148207,31.81818182,23.3,8.216845878,17.94058826,50964,57.46853241,0,0,0,0,0,0,0,0,0,0,0,0,0,0,0
53031,2017,23,31234,"Washington","Jefferson",2,2,0,12.7,13.54326559,16.36197208,0.955163133,1.841396967,3.840346616,13.15236657,33.33552157,24.5,7.080834303,10.91224591,53421,57.46853241,0,0,0,0,0,0,0,0,0,0,0,0,0,0,0
53031,2018,24,31729,"Washington","Jefferson",6,3,3,12.7,13.12418617,14.77632316,0.947365041,1.798387874,3.853688301,12.62082919,34.70246315,26.8,7.263880441,7.424395161,53345,57.46853241,2,2,2,2,2,2,2,2,2,2,0,0,0,0,0
53031,2019,20,32221,"Washington","Jefferson",0,0,0,12.6,13.12418617,14.77632316,1.002113082,1.866555677,3.614650701,12.2718832,35.56701031,29,6.122618751,7.459219231,53364,57.46853241,6,8,8,8,8,3,5,5,5,5,3,3,3,3,3
53033,2015,904,2117125,"Washington","King",0,0,0,9.8,11.1,18.4,6.265013214,15.86349183,9.319185756,21.11938229,11.89684849,22.2,5.235202859,13.67227055,71779,3.207147292,0,0,0,0,0,0,0,0,0,0,0,0,0,0,0
53033,2016,863,2149970,"Washington","King",0,0,0,9.3,10.4,21.2,6.350389213,16.36775968,9.418130192,20.96038062,12.17476047,22.3,4.601700535,13.6651045,75738,3.207147292,0,0,0,0,0,0,0,0,0,0,0,0,0,0,0
53033,2017,968,2188649,"Washington","King",9,6,3,9.3,10.11553727,22.00571004,6.395701718,16.89819921,9.482104269,20.71554585,12.44073921,22.2,4.442974033,8.666526131,81816,3.207147292,0,0,0,0,0,0,0,0,0,0,0,0,0,0,0
53033,2018,963,2233163,"Washington","King",8,3,5,9.2,9.383454984,19.46464092,6.38632167,17.41773141,9.532598129,20.63410187,12.6982237,21.7,3.939308171,6.484247996,85907,3.207147292,9,9,9,9,9,6,6,6,6,6,3,3,3,3,3
53033,2019,895,2252782,"Washington","King",0,0,0,7.7,9.383454984,19.46464092,6.42706985,18.24207536,9.70516515,20.4395497,12.97188357,22.3,3.698561544,5.629697164,89519,3.207147292,8,17,17,17,17,3,9,9,9,9,5,8,8,8,8
53035,2015,139,260131,"Washington","Kitsap",0,0,0,9.9,16.9,17.2,2.759009009,5.265624016,6.98985699,21.23141498,15.29011529,30.3,6.803135814,13.72100543,62516,16.7417265,0,0,0,1,1,0,0,0,1,1,0,0,0,0,0
53035,2016,137,264811,"Washington","Kitsap",0,0,0,10.1,13.3,19.4,2.695695621,5.360704689,7.2144872,20.86646235,16.06047611,29.5,6.295294658,13.63388887,61898,16.7417265,0,0,0,0,1,0,0,0,0,1,0,0,0,0,0
53035,2017,144,266414,"Washington","Kitsap",5,4,1,8.3,13.76221199,19.28671125,2.774371374,5.444948891,7.544275769,20.73609066,16.5124495,29.6,5.48124745,8.278874496,65814,16.7417265,0,0,0,0,0,0,0,0,0,0,0,0,0,0,0
53035,2018,147,269805,"Washington","Kitsap",4,1,3,9.1,12.09312585,18.4230724,2.731382005,5.41593816,7.552556352,20.64038125,17.02157388,29.5,5.779650813,5.787027125,68706,16.7417265,5,5,5,5,5,4,4,4,4,4,1,1,1,1,1
53035,2019,146,271473,"Washington","Kitsap",0,0,0,7.5,12.09312585,18.4230724,2.786640342,5.431396248,7.774366212,20.61978725,17.29901582,30.3,4.903223676,6.297426048,72795,16.7417265,4,9,9,9,9,1,5,5,5,5,3,4,4,4,4
53037,2015,15,43269,"Washington","Kittitas",2,2,0,20,15.3,17.3,1.005626721,2.224350533,8.442475757,18.03663355,14.4187717,27.1,7.444156362,17.5392438,47287,40.0562141,1,1,16,21,21,0,0,7,11,11,1,1,9,10,10
53037,2016,15,44866,"Washington","Kittitas",3,2,1,18.2,15.7,20.9,1.004186068,2.328206575,8.828371196,18.11062509,14.57363247,27.5,7.11893216,19.34033427,48127,40.0562141,2,3,3,18,23,2,2,2,9,13,0,1,1,9,10
53037,2017,16,46205,"Washington","Kittitas",15,10,5,14.2,16.13981054,19.22610318,1.003027572,2.361968153,8.853913888,17.77022811,15.11474728,28.9,6.144016909,12.17599906,47378,40.0562141,3,5,6,6,21,2,4,4,4,11,1,1,2,2,10
53037,2018,16,47364,"Washington","Kittitas",10,4,6,15.8,15.57745428,19.17751455,1.023046405,2.309098204,8.817367271,17.33160968,15.51063166,29.5,6.023651146,8.867308304,50410,40.0562141,15,18,20,21,21,10,12,14,14,14,5,6,6,7,7
53037,2019,22,47935,"Washington","Kittitas",0,0,0,14,15.57745428,19.17751455,0.991234715,2.278974137,8.934098041,17.20160156,15.71691375,30,5.308619759,7.806156969,56393,40.0562141,10,25,28,30,31,4,14,16,18,18,6,11,12,12,13
53041,2015,59,75882,"Washington","Lewis",1,1,0,15.3,20.1,14,0.661951759,1.013572009,9.41383306,22.2466403,18.95819182,31.5,11.21857542,18.01622407,41325,60.65469485,0,0,0,0,0,0,0,0,0,0,0,0,0,0,0
53041,2016,50,77066,"Washington","Lewis",0,0,0,14.7,15.3,18.5,0.693483122,1.040890214,9.738047066,21.91593015,19.80087318,33.1,9.228983264,18.12921571,44243,60.65469485,1,1,1,1,1,1,1,1,1,1,0,0,0,0,0
53041,2017,63,78200,"Washington","Lewis",3,1,2,15,17.58052337,17.33368478,0.715584724,1.139927783,10.01555046,21.84180702,20.21691574,32.8,8.317531737,12.99403805,47619,60.65469485,0,1,1,1,1,0,1,1,1,1,0,0,0,0,0
53041,2018,62,79604,"Washington","Lewis",5,1,4,12.5,16.83235924,16.19587455,0.666960787,1.173020528,10.05501778,21.62172683,20.78867464,34.3,8.085623481,9.088933104,47127,60.65469485,3,3,4,4,4,1,1,2,2,2,2,2,2,2,2
53041,2019,52,80707,"Washington","Lewis",0,0,0,12.2,16.83235924,16.19587455,0.696930946,1.222506394,10.14066496,21.56393862,20.67391304,33.6,6.645350065,7.790193462,50086,60.65469485,5,8,8,9,9,1,2,2,3,3,4,6,6,6,6
53045,2015,35,61023,"Washington","Mason",1,1,0,16.9,24.9,16.1,1.167000017,1.292626081,8.585549697,19.53154702,20.64565185,32.2,9.748722317,18.80634265,46886,63.69627177,0,0,1,1,1,0,0,1,1,1,0,0,0,0,0
53045,2016,28,62198,"Washington","Mason",0,0,0,14.9,15.5,19.3,1.205712309,1.314424075,8.851773155,19.27163117,21.30750605,32.7,8.535119354,20.12777463,52313,63.69627177,1,1,1,2,2,1,1,1,2,2,0,0,0,0,0
53045,2017,36,63710,"Washington","Mason",2,0,2,14.5,16.75789954,20.443643,1.16841191,1.407665962,9.145731937,19.18456975,21.87208102,30.5,7.651375359,13.3739739,54175,63.69627177,0,1,1,1,2,0,1,1,1,2,0,0,0,0,0
53045,2018,54,65507,"Washington","Mason",6,3,3,13.7,16.32945468,17.22538189,1.138300267,1.286214991,9.403839352,19.10511592,22.44766713,31.1,7.835741832,10.6781789,52758,63.69627177,2,2,3,3,3,0,0,1,1,1,2,2,2,2,2
53045,2019,28,66768,"Washington","Mason",0,0,0,12.8,16.32945468,17.22538189,1.2117407,1.335740072,9.888557526,19.37215508,22.58829069,32.9,6.588935956,9.87673276,55030,63.69627177,6,8,8,9,9,3,3,3,4,4,3,5,5,5,5
53047,2015,16,41516,"Washington","Okanogan",14,4,10,20.5,23.5,15.1,0.541354114,1.022018304,18.80902095,23.36804797,19.38193382,29.2,8.668191765,25.53895697,39014,79.98784047,3,3,11,11,11,2,2,7,7,7,1,1,4,4,4
53047,2016,18,41554,"Washington","Okanogan",0,0,0,19.7,17.9,16.6,0.56187939,1.034148704,19.01428917,23.39549528,19.83046743,28.9,7.376740685,26.20791512,37782,79.98784047,14,17,17,25,25,4,6,6,11,11,10,11,11,14,14
53047,2017,21,41742,"Washington","Okanogan",16,3,13,20.4,19.48070232,17.69644065,0.640716832,1.216398497,19.21668754,23.18624145,20.4716254,28,6.898345154,18.6054318,41844,79.98784047,0,14,17,17,25,0,4,6,6,11,0,10,11,11,14
53047,2018,17,42132,"Washington","Okanogan",24,4,20,17,18.02705466,15.8658887,0.697887087,1.188814555,19.50714733,23.02786735,20.94142562,31,6.928717282,14.49681372,41726,79.98784047,16,16,30,33,33,3,3,7,9,9,13,13,23,24,24
53047,2019,17,42243,"Washington","Okanogan",0,0,0,16.4,18.02705466,15.8658887,0.711513583,1.169086292,20.03737243,23.22840305,21.1777107,32.2,6.870520784,13.80835228,44819,79.98784047,24,40,40,54,57,4,7,7,11,13,20,33,33,43,44
53053,2015,346,843954,"Washington","Pierce",5,5,0,12.4,17.8,16,6.711371735,6.379804402,9.873826309,24.2053912,12.29202323,31.4,8.059084849,16.02490886,57619,6.59071332,0,0,1,3,3,0,0,1,3,3,0,0,0,0,0
53053,2016,278,861312,"Washington","Pierce",1,1,0,12.1,16.7,20,6.778110606,6.551889106,10.18201094,24.02443481,12.66612015,31,7.208033237,14.83264622,60397,6.59071332,5,5,5,6,8,5,5,5,6,8,0,0,0,0,0
53053,2017,299,876764,"Washington","Pierce",8,4,4,10.2,14.55220948,18.63528504,6.82477955,6.65071793,10.46680269,23.8425317,13.05319958,30,6.334016221,10.77809685,60168,6.59071332,1,6,6,6,7,1,6,6,6,7,0,0,0,0,0
53053,2018,287,891299,"Washington","Pierce",7,2,5,8.7,14.681201,19.11313791,6.840610603,6.583560893,10.5858272,23.73483709,13.36136034,30.5,6.275803084,7.323053755,64312,6.59071332,8,9,14,14,14,4,5,10,10,10,4,4,4,4,4
53053,2019,288,904980,"Washington","Pierce",0,0,0,9.4,14.681201,19.11313791,6.88953926,6.696328773,10.90875082,23.60167616,13.4469481,31.2,5.363370316,6.542241189,69027,6.59071332,7,15,16,21,21,2,6,7,12,12,5,9,9,9,9
53057,2015,98,121846,"Washington","Skagit",0,0,0,14.9,16.1,16.4,0.599139999,2.146637832,17.56860237,22.65119449,18.11641156,27.7,8.265172803,18.49231721,52525,29.02113754,0,0,0,0,0,0,0,0,0,0,0,0,0,0,0
53057,2016,89,123681,"Washington","Skagit",0,0,0,11.3,14.9,18.9,0.650521331,2.22822249,17.76430025,22.52232792,18.73135878,28.4,7.357410418,18.64675032,51395,29.02113754,0,0,0,0,0,0,0,0,0,0,0,0,0,0,0
53057,2017,109,125619,"Washington","Skagit",0,0,0,11.3,14.56088583,18.48467766,0.658207902,2.256126586,17.87912611,22.27648015,19.30059255,26.4,6.667721964,13.51142442,56891,29.02113754,0,0,0,0,0,0,0,0,0,0,0,0,0,0,0
53057,2018,91,128206,"Washington","Skagit",5,2,3,9.7,15.27139831,18.60448784,0.692103072,2.271165337,17.99225427,21.98801756,19.95294346,25.4,6.785579139,9.784629289,60442,29.02113754,0,0,0,0,0,0,0,0,0,0,0,0,0,0,0
53057,2019,74,129205,"Washington","Skagit",0,0,0,11.2,15.27139831,18.60448784,0.754662909,2.338022115,18.32286517,21.8979613,20.21429879,27.7,5.50003365,8.508986135,65505,29.02113754,5,5,5,5,5,2,2,2,2,2,3,3,3,3,3
53061,2015,331,772501,"Washington","Snohomish",2,2,0,9.3,15.6,18.4,2.704739025,9.850076349,9.497622377,23.37779339,11.71584354,28.1,5.838123477,14.90173815,67443,10.8194607,0,0,1,2,2,0,0,1,2,2,0,0,0,0,0
53061,2016,315,787620,"Washington","Snohomish",1,1,0,8,12.9,17.7,2.821811441,10.15372909,9.700585716,23.18219339,12.07438818,28.6,5.142254366,14.53328906,71890,10.8194607,2,2,2,3,4,2,2,2,3,4,0,0,0,0,0
53061,2017,376,801633,"Washington","Snohomish",6,5,1,7.3,12.95194407,18.3693308,2.895659682,10.44335218,9.900440258,22.94314182,12.45474116,29.4,4.829218752,9.824495394,76053,10.8194607,1,3,3,3,4,1,3,3,3,4,0,0,0,0,0
53061,2018,375,814901,"Washington","Snohomish",7,2,5,7.5,13.1652467,18.79440366,3.067723014,10.65221808,9.920266118,22.80223966,12.83880552,29.1,4.357583374,7.021188512,78582,10.8194607,6,7,9,9,9,5,6,8,8,8,1,1,1,1,1
53061,2019,371,822083,"Washington","Snohomish",1,1,0,7,13.1652467,18.79440366,3.197972139,11.12928235,10.20529345,22.73322081,13.04025658,29,4.124650841,6.352034723,82405,10.8194607,7,13,14,16,16,2,7,8,10,10,5,6,6,6,6
53063,2015,301,490945,"Washington","Spokane",14,10,4,15.5,18.7,17.4,1.7417678,2.253659798,5.033187456,22.60459994,14.322129,28.2,7.873970291,14.95367124,47577,13.67171667,1,2,4,4,4,1,2,4,4,4,0,0,0,0,0
53063,2016,274,499072,"Washington","Spokane",0,0,0,13.3,15.5,20.6,1.794069186,2.333177788,5.228383005,22.47077334,14.76963483,28.4,7.145682151,16.53581269,50083,13.67171667,14,15,16,18,18,10,11,12,14,14,4,4,4,4,4
53063,2017,322,506152,"Washington","Spokane",16,7,9,14.1,15.39055628,18.03749475,1.86008616,2.373381947,5.417918504,22.38458483,15.17196427,29.2,6.42128996,9.584551554,48676,13.67171667,0,14,15,16,18,0,10,11,12,14,0,4,4,4,4
53063,2018,346,514631,"Washington","Spokane",12,4,8,13,15.8687637,19.15844511,1.824987176,2.356573801,5.49419723,22.22024077,15.55687356,29.2,6.33853265,6.367188369,52933,13.67171667,16,16,30,31,32,7,7,17,18,19,9,9,13,13,13
53063,2019,326,522798,"Washington","Spokane",0,0,0,12.9,15.8687637,19.15844511,1.836800013,2.400267113,5.739185067,22.20498981,15.74803616,29.1,5.405101884,6.302029567,53438,13.67171667,12,28,28,42,43,4,11,11,21,22,8,17,17,21,21
53065,2015,11,43791,"Washington","Stevens",10,5,5,19.7,22.4,17.8,0.490444393,0.667741193,3.327193184,22.44301174,19.93092333,28.8,10.8644308,17.79749922,43675,79.20562358,2,2,2,2,2,1,1,1,1,1,1,1,1,1,1
53065,2016,16,44439,"Washington","Stevens",0,0,0,14.3,17,18.9,0.504009164,0.726231386,3.489117984,22.1443299,20.69644903,30.3,9.446532286,19.00551217,43823,79.20562358,10,12,12,12,12,5,6,6,6,6,5,6,6,6,6
53065,2017,13,44730,"Washington","Stevens",13,7,6,14.8,17.13398666,16.81962902,0.534356375,0.696490146,3.480167158,22.04334224,21.49985157,30.6,8.758667728,13.21410974,42845,79.20562358,0,10,12,12,12,0,5,6,6,6,0,5,6,6,6
53065,2018,31,45260,"Washington","Stevens",17,8,9,13.5,15.81407813,17.67281883,0.481558991,0.780845654,3.589189676,21.9469385,22.08195504,28.5,8.56617032,8.543228679,51303,79.20562358,13,13,23,25,25,7,7,12,13,13,6,6,11,12,12
53065,2019,15,45723,"Washington","Stevens",0,0,0,14.9,15.81407813,17.67281883,0.444891572,0.773530069,3.760339817,21.74826738,22.57321708,29.8,7.263180923,7.824282458,52136,79.20562358,17,30,30,40,42,8,15,15,20,21,9,15,15,20,21
53067,2015,135,269536,"Washington","Thurston",1,1,0,12.2,19.1,15.9,2.984130372,5.507492721,8.072015489,22.26092657,14.67521381,29.2,7.028441447,14.66257725,59877,20.9887261,0,3,6,7,7,0,3,5,6,6,0,0,1,1,1
53067,2016,118,275222,"Washington","Thurston",0,0,0,10.4,14.3,19.2,3.067507739,5.737424347,8.385148072,22.13119379,15.20250065,28.6,6.647227479,13.88832331,61653,20.9887261,1,1,4,7,8,1,1,4,6,7,0,0,0,1,1
53067,2017,149,280588,"Washington","Thurston",4,3,1,10.5,14.50262953,19.15218981,3.125742016,5.989181408,8.578445922,21.8004274,15.86133207,28.1,5.911483006,9.583009117,62299,20.9887261,0,1,1,4,7,0,1,1,4,6,0,0,0,0,1
53067,2018,171,286419,"Washington","Thurston",6,1,5,8.7,13.48737276,17.03899942,3.144007383,6.014780795,8.596333142,21.71846727,16.45326318,27.9,5.819996479,6.61136721,65684,20.9887261,4,4,5,5,8,3,3,4,4,7,1,1,1,1,1
53067,2019,169,290536,"Washington","Thurston",0,0,0,9.1,13.48737276,17.03899942,3.077109499,6.136399276,8.987554707,21.6416953,16.66821104,29.7,4.966369293,5.563874014,71370,20.9887261,6,10,10,11,11,1,4,4,5,5,5,6,6,6,6
53071,2015,54,60338,"Washington","Walla Walla",4,1,3,16.5,12.9,14.1,1.711741979,1.543759449,20.88862758,21.93011927,16.09776583,27.1,7.001438652,18.25231782,46294,17.12458107,0,2,2,2,2,0,2,2,2,2,0,0,0,0,0
53071,2016,51,60340,"Washington","Walla Walla",0,0,0,14.2,14.1,20.3,1.803021188,1.674353319,21.20346234,21.74152797,16.54635385,26.1,6.516591865,18.41984883,49819,17.12458107,4,4,6,6,6,1,1,3,3,3,3,3,3,3,3
53071,2017,71,60567,"Washington","Walla Walla",11,8,3,13.6,14.50724622,19.52715279,1.813119427,1.617554443,21.59667208,21.43591104,16.87493785,28,5.796072025,13.5236845,50120,17.12458107,0,4,4,6,6,0,1,1,3,3,0,3,3,3,3
53071,2018,63,60922,"Washington","Walla Walla",8,5,3,13.3,14.77134642,18.2194956,1.942326815,1.610871727,21.21146835,21.4103414,17.31521379,28.2,5.638629284,9.030532845,53598,17.12458107,11,11,15,15,17,8,8,9,9,11,3,3,6,6,6
53071,2019,51,60760,"Washington","Walla Walla",0,0,0,12.7,14.77134642,18.2194956,1.981276933,1.596578995,21.32184193,21.14682913,17.48476893,29.3,4.924242424,8.198130676,54243,17.12458107,8,19,19,23,23,5,13,13,14,14,3,6,6,9,9
53073,2015,109,212284,"Washington","Whatcom",0,0,0,14.4,13.8,17.4,1.004589223,4.141931545,8.641987274,20.3040421,14.91231046,25.1,6.879959887,18.14558716,51119,25.87352093,0,0,0,0,0,0,0,0,0,0,0,0,0,0,0
53073,2016,113,216800,"Washington","Whatcom",0,0,0,15.2,13.6,21.8,0.989196116,4.261078661,8.944521505,20.19524744,15.43453115,23.3,6.644612848,18.68016984,53733,25.87352093,0,0,0,0,0,0,0,0,0,0,0,0,0,0,0
53073,2017,142,221404,"Washington","Whatcom",7,5,2,13,14.1135658,19.73077663,1.01938912,4.41436943,9.17968382,19.82532833,15.97812365,23.1,5.936765192,11.8577813,55073,25.87352093,0,0,0,0,0,0,0,0,0,0,0,0,0,0,0
53073,2018,134,225685,"Washington","Whatcom",6,3,3,14.9,13.00525119,20.57959672,1.023523985,4.373616236,9.237546126,19.67435424,16.57241697,23.1,6.015414616,9.108983927,56636,25.87352093,7,7,7,7,7,5,5,5,5,5,2,2,2,2,2
53073,2019,140,229247,"Washington","Whatcom",0,0,0,12.7,13.00525119,20.57959672,1.027081715,4.465140648,9.403624144,19.53713573,16.88361547,25.4,5.009357341,8.612206124,61026,25.87352093,6,13,13,13,13,3,8,8,8,8,3,5,5,5,5
53075,2015,23,48177,"Washington","Whitman",5,3,2,20.8,11.2,16.7,2.03779257,7.777539188,5.357526305,15.0225467,9.8325102,26.1,6.181697235,15.24895392,42702,27.53037341,0,0,1,1,1,0,0,1,1,1,0,0,0,0,0
53075,2016,15,48851,"Washington","Whitman",0,0,0,25.9,17.6,22.6,2.184637068,7.745531424,5.605740278,15.21771628,10.01345378,24.2,5.503422639,16.00078012,41837,27.53037341,5,5,5,6,6,3,3,3,4,4,2,2,2,2,2
53075,2017,22,49046,"Washington","Whitman",10,5,5,21.4,16.22608521,21.15065714,2.328912137,7.796251323,5.890777757,15.01753949,9.959109119,22.9,4.665171701,9.45945946,43817,27.53037341,0,5,5,5,6,0,3,3,3,4,0,2,2,2,2
53075,2018,28,49791,"Washington","Whitman",5,3,2,25.4,15.65096858,20.24365572,2.380708686,8.184069927,6.153405253,15.26887884,10.06939469,25.8,5.132428801,6.021808713,42693,27.53037341,10,10,15,15,15,5,5,8,8,8,5,5,7,7,7
53075,2019,27,50104,"Washington","Whitman",0,0,0,26.3,15.65096858,20.24365572,2.126575052,8.320760103,6.430697712,15.07360437,10.14557762,27.2,4.427871298,6.401901608,44913,27.53037341,5,15,15,20,20,3,8,8,11,11,2,7,7,9,9
53077,2015,102,248830,"Washington","Yakima",6,3,3,19.1,15.7,13.8,0.79297615,1.410679879,47.04344165,29.9776558,12.46700993,31.3,9.187554784,25.33505203,41918,23.51920602,4,11,16,22,22,4,11,15,20,20,0,0,1,2,2
53077,2016,116,249636,"Washington","Yakima",5,2,3,18.2,16.9,18.9,0.794954923,1.455062236,47.69204682,29.83240945,12.80608187,29.1,8.924051694,26.95248536,44342,23.51920602,6,10,17,22,28,3,7,14,18,23,3,3,3,4,5
53077,2017,108,250193,"Washington","Yakima",21,15,6,18.1,16.88509254,16.89510126,0.790901419,1.480528875,48.32375517,29.76449785,13.12623076,29.6,7.960541409,18.25058413,46891,23.51920602,5,11,15,22,27,2,5,9,16,20,3,6,6,6,7
53077,2018,115,251446,"Washington","Yakima",9,0,9,16.5,15.18003206,16.80978618,0.795558333,1.457722444,48.79744909,29.87870339,13.39991027,30.9,7.993227022,15.47761399,48232,23.51920602,21,26,32,36,43,15,17,20,24,31,6,9,12,12,12
53077,2019,84,250873,"Washington","Yakima",0,0,0,16.7,15.18003206,16.80978618,0.818168374,1.510433945,49.43903307,29.74263868,13.45121566,32.1,6.783162742,13.20507694,47573,23.51920602,9,30,35,41,45,0,15,17,20,24,9,15,18,21,21
